biosampleA	biosampleB	nSharedPredAwB	nTotalPredA	nTotalPredB	nAnotB	nBnotA	Spearman	Pearson	Pearson_log1p
K562_Xu	K562_Xu	56539	56539	56539	0	0	1	1	1
K562_Xu	K562_IGVF	31902	56539	59116	24637	27214	0.1514809	0.3588204	0.2642467
K562_Xu	K562_Wang	33462	56539	56832	23077	23370	0.221043	0.4064395	0.3145954
K562_Xu	GM12878	16057	56539	54448	40482	38391	-0.2595897	0.05814918	-0.05434304
K562_Xu	BMMC5_B	17460	56539	67427	39079	49967	-0.2568591	0.07941853	-0.03650505
K562_Xu	BMMC5_T	17949	56539	66240	38590	48291	-0.2574603	0.05859506	-0.05277149
K562_Xu	BMMC5_Myeloid	18818	56539	66645	37721	47827	-0.218104	0.1077623	-0.007389024
K562_Xu	BMMC5_Dendritic	17693	56539	63327	38846	45634	-0.2379641	0.09090326	-0.0236427
K562_Xu	BMMC5_Erythroid	24194	56539	65700	32345	41506	-0.08775191	0.1873656	0.08131548
K562_Xu	BMMC22_B1_B	16553	56539	63712	39986	47159	-0.2652969	0.07779394	-0.03904365
K562_Xu	BMMC22_CD4_pos_T_activated	17706	56539	67674	38833	49968	-0.256751	0.07189688	-0.04194482
K562_Xu	BMMC22_CD4_pos_T_naive	17563	56539	65164	38976	47601	-0.2540706	0.07226975	-0.041542
K562_Xu	BMMC22_CD8_pos_T	16375	56539	56554	40164	40179	-0.2533422	0.07224264	-0.04025445
K562_Xu	BMMC22_CD8_pos_T_naive	16249	56539	63902	40290	47653	-0.277837	0.06338246	-0.05219072
K562_Xu	BMMC22_CD14_pos_Mono	18155	56539	64846	38384	46691	-0.228723	0.102275	-0.01359766
K562_Xu	BMMC22_CD16_pos_Mono	16118	56539	61683	40421	45565	-0.2720487	0.06909933	-0.04734428
K562_Xu	BMMC22_cDC2	16604	56539	60955	39935	44351	-0.2567971	0.07689904	-0.03820558
K562_Xu	BMMC22_Erythroblast	21753	56539	62295	34786	40542	-0.1349732	0.1574273	0.04985024
K562_Xu	BMMC22_G_M_prog	18613	56539	63921	37926	45308	-0.2166543	0.1073687	-0.006131189
K562_Xu	BMMC22_HSC	19056	56539	64808	37483	45752	-0.206886	0.1165228	0.003456777
K562_Xu	BMMC22_ID2_hi_myeloid_prog	7575	56539	35748	48964	28173	-0.4908387	-0.2074101	-0.3055168
K562_Xu	BMMC22_ILC	14065	56539	56304	42474	42239	-0.3276564	0.01081964	-0.1025856
K562_Xu	BMMC22_Lymph_prog	17519	56539	66487	39020	48968	-0.2553727	0.07629355	-0.03827436
K562_Xu	BMMC22_MK_E_prog	21982	56539	63497	34557	41515	-0.1278017	0.1740279	0.06510178
K562_Xu	BMMC22_Naive_CD20_pos_B	16513	56539	63355	40026	46842	-0.2688478	0.07207367	-0.04415391
K562_Xu	BMMC22_NK	17433	56539	66621	39106	49188	-0.2559862	0.07865954	-0.03655395
K562_Xu	BMMC22_Normoblast	15360	56539	56020	41179	40660	-0.3011953	0.02209572	-0.08642961
K562_Xu	BMMC22_pDC	17114	56539	61970	39425	44856	-0.2463317	0.08907372	-0.02656524
K562_Xu	BMMC22_Plasma_cell	16141	56539	65478	40398	49337	-0.2874399	0.05130039	-0.06387583
K562_Xu	BMMC22_Proerythroblast	23548	56539	63281	32991	39733	-0.08176182	0.2094092	0.1009043
K562_Xu	BMMC22_Transitional_B	16302	56539	63246	40237	46944	-0.2698178	0.07415684	-0.04279962
K562_Xu	PBMC5_B	15971	56539	61777	40568	45806	-0.2870238	0.04962479	-0.06501101
K562_Xu	PBMC5_DC	14882	56539	54841	41657	39959	-0.2931624	0.03764934	-0.07541307
K562_Xu	PBMC5_Mono	16238	56539	63455	40301	47217	-0.2865016	0.04631041	-0.06832809
K562_Xu	PBMC5_NK	14768	56539	58922	41771	44154	-0.3149464	0.02243802	-0.09082768
K562_Xu	PBMC5_T	16465	56539	59027	40074	42562	-0.2792468	0.0386515	-0.07115489
K562_Xu	PBMC_10_cDC	15212	56539	55848	41327	40636	-0.2879485	0.04185692	-0.07106611
K562_Xu	PBMC_11_CD14.Mono.1	14500	56539	59470	42039	44970	-0.3168481	0.02810289	-0.08753831
K562_Xu	PBMC_12_CD14.Mono.2	15506	56539	59397	41033	43891	-0.2847149	0.05662751	-0.05961389
K562_Xu	PBMC_13_CD16.Mono	14164	56539	54592	42375	40428	-0.3138717	0.02063057	-0.09279377
K562_Xu	PBMC_17_B	14930	56539	58277	41609	43347	-0.2993399	0.04457008	-0.07115693
K562_Xu	PBMC_20_CD4.N1	14390	56539	60378	42149	45988	-0.3322278	0.01031218	-0.1032284
K562_Xu	PBMC_22_CD4.M	16607	56539	59146	39932	42539	-0.2706017	0.05203266	-0.05933949
K562_Xu	PBMC_24_CD8.CM	15264	56539	59210	41275	43946	-0.3040867	0.03120679	-0.08138205
K562_Xu	PBMC_25_NK	14689	56539	57699	41850	43010	-0.3128556	0.02433508	-0.08891562
K562_Xu	Islets_beta	16455	56539	63734	40084	47279	-0.2928595	0.02705399	-0.08329638
K562_Xu	Islets_alpha	16421	56539	65486	40118	49065	-0.2887352	0.04420982	-0.06794732
K562_Xu	Islets_delta	16640	56539	61673	39899	45033	-0.2695418	0.05977969	-0.05245897
K562_Xu	Islets_PP	15726	56539	63824	40813	48098	-0.2987932	0.04587425	-0.06864201
K562_Xu	Islets_acinar	18154	56539	66719	38385	48565	-0.2501746	0.07298865	-0.03914614
K562_Xu	Islets_duct	16920	56539	63744	39619	46824	-0.264624	0.06977606	-0.04372795
K562_Xu	Islets_endothelial	15865	56539	64155	40674	48290	-0.3022769	0.03222349	-0.08001233
K562_Xu	Islets_immune	16514	56539	67939	40025	51425	-0.3037381	0.02533032	-0.0861266
K562_Xu	Islets_mesenchymal	17342	56539	62786	39197	45444	-0.2581265	0.06560806	-0.04485659
K562_Xu	HCT116	18310	56539	64892	38229	46582	-0.2414061	0.07332648	-0.03697084
K562_Xu	WTC11_from_HPC_diff	17236	56539	58398	39303	41162	-0.2359708	0.09355347	-0.01869843
K562_Xu	Jurkat	16000	56539	58783	40539	42783	-0.3111501	0.001028252	-0.1063819
K562_IGVF	K562_IGVF	59116	59116	59116	0	0	1	1	1
K562_IGVF	K562_Wang	37697	59116	56832	21419	19135	0.3484223	0.5156188	0.4275336
K562_IGVF	GM12878	17854	59116	54448	41262	36594	-0.1951653	0.1376572	0.02178132
K562_IGVF	BMMC5_B	18867	59116	67427	40249	48560	-0.237921	0.1056742	-0.01044303
K562_IGVF	BMMC5_T	18655	59116	66240	40461	47585	-0.2445263	0.08756105	-0.02580189
K562_IGVF	BMMC5_Myeloid	20022	59116	66645	39094	46623	-0.2058872	0.1255971	0.01109676
K562_IGVF	BMMC5_Dendritic	19347	59116	63327	39769	43980	-0.2087646	0.1251303	0.01069042
K562_IGVF	BMMC5_Erythroid	24118	59116	65700	34998	41582	-0.09839168	0.196446	0.08758427
K562_IGVF	BMMC22_B1_B	17989	59116	63712	41127	45723	-0.2385976	0.1133114	-0.004425092
K562_IGVF	BMMC22_CD4_pos_T_activated	18824	59116	67674	40292	48850	-0.237918	0.1039193	-0.0113095
K562_IGVF	BMMC22_CD4_pos_T_naive	18691	59116	65164	40425	46473	-0.2306786	0.1095348	-0.006079246
K562_IGVF	BMMC22_CD8_pos_T	17623	59116	56554	41493	38931	-0.2194661	0.1193265	0.0048836
K562_IGVF	BMMC22_CD8_pos_T_naive	17767	59116	63902	41349	46135	-0.248078	0.1019965	-0.01465611
K562_IGVF	BMMC22_CD14_pos_Mono	19209	59116	64846	39907	45637	-0.2218309	0.1139775	-0.0009329032
K562_IGVF	BMMC22_CD16_pos_Mono	18276	59116	61683	40840	43407	-0.2195348	0.128213	0.01064984
K562_IGVF	BMMC22_cDC2	19071	59116	60955	40045	41884	-0.1947043	0.1443265	0.02844868
K562_IGVF	BMMC22_Erythroblast	22412	59116	62295	36704	39883	-0.1200262	0.1883549	0.07819028
K562_IGVF	BMMC22_G_M_prog	20851	59116	63921	38265	43070	-0.1722567	0.1551669	0.04161324
K562_IGVF	BMMC22_HSC	21345	59116	64808	37771	43463	-0.165435	0.159045	0.04646669
K562_IGVF	BMMC22_ID2_hi_myeloid_prog	10216	59116	35748	48900	25532	-0.3601228	-0.05440379	-0.1584206
K562_IGVF	BMMC22_ILC	16603	59116	56304	42513	39701	-0.2417523	0.1108348	-0.006274436
K562_IGVF	BMMC22_Lymph_prog	19360	59116	66487	39756	47127	-0.220178	0.1197604	0.00427098
K562_IGVF	BMMC22_MK_E_prog	24017	59116	63497	35099	39480	-0.09017813	0.2139919	0.105573
K562_IGVF	BMMC22_Naive_CD20_pos_B	18250	59116	63355	40866	45105	-0.2328754	0.1169258	-0.0004040813
K562_IGVF	BMMC22_NK	18642	59116	66621	40474	47979	-0.2315756	0.1165058	-0.0006980693
K562_IGVF	BMMC22_Normoblast	17856	59116	56020	41260	38164	-0.2138618	0.1243733	0.011581
K562_IGVF	BMMC22_pDC	18353	59116	61970	40763	43617	-0.2342483	0.1052078	-0.009879548
K562_IGVF	BMMC22_Plasma_cell	18490	59116	65478	40626	46988	-0.2290173	0.1191981	0.001995959
K562_IGVF	BMMC22_Proerythroblast	23871	59116	63281	35245	39410	-0.09525875	0.2071201	0.09808159
K562_IGVF	BMMC22_Transitional_B	18039	59116	63246	41077	45207	-0.2366535	0.1137168	-0.003651657
K562_IGVF	PBMC5_B	18186	59116	61777	40930	43591	-0.2251739	0.1230453	0.006048371
K562_IGVF	PBMC5_DC	17698	59116	54841	41418	37143	-0.2048566	0.1342222	0.01886597
K562_IGVF	PBMC5_Mono	18541	59116	63455	40575	44914	-0.2269795	0.1145696	-0.001683328
K562_IGVF	PBMC5_NK	16868	59116	58922	42248	42054	-0.2450823	0.1095113	-0.00777084
K562_IGVF	PBMC5_T	17689	59116	59027	41427	41338	-0.2366593	0.09997698	-0.01332496
K562_IGVF	PBMC_10_cDC	18146	59116	55848	40970	37702	-0.1951239	0.1429385	0.02770475
K562_IGVF	PBMC_11_CD14.Mono.1	17056	59116	59470	42060	42414	-0.245402	0.1083354	-0.009351951
K562_IGVF	PBMC_12_CD14.Mono.2	17646	59116	59397	41470	41751	-0.2287838	0.1199546	0.002469971
K562_IGVF	PBMC_13_CD16.Mono	16712	59116	54592	42404	37880	-0.2312108	0.1146783	-0.001659428
K562_IGVF	PBMC_17_B	16906	59116	58277	42210	41371	-0.2402937	0.1163365	-0.001831939
K562_IGVF	PBMC_20_CD4.N1	16770	59116	60378	42346	43608	-0.2543163	0.1052006	-0.01235502
K562_IGVF	PBMC_22_CD4.M	17642	59116	59146	41474	41504	-0.2335815	0.1086268	-0.006193086
K562_IGVF	PBMC_24_CD8.CM	17266	59116	59210	41850	41944	-0.239169	0.1130979	-0.00335946
K562_IGVF	PBMC_25_NK	16745	59116	57699	42371	40954	-0.242517	0.111973	-0.00531198
K562_IGVF	Islets_beta	17208	59116	63734	41908	46526	-0.267299	0.07349223	-0.04087433
K562_IGVF	Islets_alpha	17134	59116	65486	41982	48352	-0.2714099	0.08163624	-0.03418572
K562_IGVF	Islets_delta	17751	59116	61673	41365	43922	-0.2382983	0.1080335	-0.007290774
K562_IGVF	Islets_PP	16993	59116	63824	42123	46831	-0.2657316	0.09423796	-0.02328521
K562_IGVF	Islets_acinar	19361	59116	66719	39755	47358	-0.2231721	0.1143497	-5.540228e-05
K562_IGVF	Islets_duct	18846	59116	63744	40270	44898	-0.2162999	0.1291206	0.01354849
K562_IGVF	Islets_endothelial	18910	59116	64155	40206	45245	-0.218852	0.1244694	0.009558737
K562_IGVF	Islets_immune	19774	59116	67939	39342	48165	-0.2188268	0.117704	0.004073527
K562_IGVF	Islets_mesenchymal	19508	59116	62786	39608	43278	-0.199746	0.1350486	0.02209409
K562_IGVF	HCT116	23014	59116	64892	36102	41878	-0.1048466	0.2127684	0.09977697
K562_IGVF	WTC11_from_HPC_diff	18745	59116	58398	40371	39653	-0.2124716	0.1206957	0.008415868
K562_IGVF	Jurkat	20611	59116	58783	38505	38172	-0.1519232	0.1741387	0.06102043
K562_Wang	K562_Wang	56832	56832	56832	0	0	1	1	1
K562_Wang	GM12878	17856	56832	54448	38976	36592	-0.1858178	0.1432064	0.0279618
K562_Wang	BMMC5_B	17947	56832	67427	38885	49480	-0.2405589	0.1051188	-0.0115488
K562_Wang	BMMC5_T	18150	56832	66240	38682	48090	-0.2383028	0.09293942	-0.02052994
K562_Wang	BMMC5_Myeloid	19062	56832	66645	37770	47583	-0.2146122	0.1180658	0.003117701
K562_Wang	BMMC5_Dendritic	18755	56832	63327	38077	44572	-0.2097278	0.1235334	0.009000362
K562_Wang	BMMC5_Erythroid	23598	56832	65700	33234	42102	-0.08939145	0.2023838	0.09369808
K562_Wang	BMMC22_B1_B	17448	56832	63712	39384	46264	-0.237082	0.114553	-0.003257805
K562_Wang	BMMC22_CD4_pos_T_activated	18178	56832	67674	38654	49496	-0.233846	0.1075401	-0.008049398
K562_Wang	BMMC22_CD4_pos_T_naive	18104	56832	65164	38728	47060	-0.2278547	0.1116563	-0.004145226
K562_Wang	BMMC22_CD8_pos_T	17297	56832	56554	39535	39257	-0.2124961	0.1269108	0.01199722
K562_Wang	BMMC22_CD8_pos_T_naive	17270	56832	63902	39562	46632	-0.2442662	0.1057956	-0.01114278
K562_Wang	BMMC22_CD14_pos_Mono	18290	56832	64846	38542	46556	-0.2285196	0.1093658	-0.006235739
K562_Wang	BMMC22_CD16_pos_Mono	17682	56832	61683	39150	44001	-0.2252799	0.1212402	0.004053351
K562_Wang	BMMC22_cDC2	18538	56832	60955	38294	42417	-0.1977108	0.139606	0.02407683
K562_Wang	BMMC22_Erythroblast	21914	56832	62295	34918	40381	-0.1127128	0.1941752	0.08390978
K562_Wang	BMMC22_G_M_prog	20026	56832	63921	36806	43895	-0.1792731	0.1474806	0.03402444
K562_Wang	BMMC22_HSC	20397	56832	64808	36435	44411	-0.1729441	0.1524181	0.03963025
K562_Wang	BMMC22_ID2_hi_myeloid_prog	10241	56832	35748	46591	25507	-0.3617532	-0.05964303	-0.1627544
K562_Wang	BMMC22_ILC	16444	56832	56304	40388	39860	-0.2373377	0.1120487	-0.004610001
K562_Wang	BMMC22_Lymph_prog	18660	56832	66487	38172	47827	-0.2169448	0.1230672	0.007331141
K562_Wang	BMMC22_MK_E_prog	23362	56832	63497	33470	40135	-0.08826751	0.2138818	0.1057153
K562_Wang	BMMC22_Naive_CD20_pos_B	17404	56832	63355	39428	45951	-0.2373242	0.1143435	-0.003377986
K562_Wang	BMMC22_NK	18108	56832	66621	38724	48513	-0.2273112	0.1194907	0.002513029
K562_Wang	BMMC22_Normoblast	17480	56832	56020	39352	38540	-0.2173352	0.1170148	0.00506423
K562_Wang	BMMC22_pDC	17669	56832	61970	39163	44301	-0.2364655	0.103786	-0.01151119
K562_Wang	BMMC22_Plasma_cell	18159	56832	65478	38673	47319	-0.2208677	0.1255113	0.008233724
K562_Wang	BMMC22_Proerythroblast	23318	56832	63281	33514	39963	-0.08953711	0.2111055	0.1021291
K562_Wang	BMMC22_Transitional_B	17297	56832	63246	39535	45949	-0.2393492	0.1119505	-0.005556709
K562_Wang	PBMC5_B	17788	56832	61777	39044	43989	-0.2207756	0.1264597	0.009438116
K562_Wang	PBMC5_DC	17494	56832	54841	39338	37347	-0.2013907	0.1345683	0.01973079
K562_Wang	PBMC5_Mono	18131	56832	63455	38701	45324	-0.2234404	0.1161182	6.056417e-05
K562_Wang	PBMC5_NK	17091	56832	58922	39741	41831	-0.228283	0.1210455	0.004486501
K562_Wang	PBMC5_T	17527	56832	59027	39305	41500	-0.2266787	0.1077583	-0.005212114
K562_Wang	PBMC_10_cDC	17927	56832	55848	38905	37921	-0.1909432	0.1448613	0.02980366
K562_Wang	PBMC_11_CD14.Mono.1	16754	56832	59470	40078	42716	-0.2425121	0.1083137	-0.008864476
K562_Wang	PBMC_12_CD14.Mono.2	17372	56832	59397	39460	42025	-0.2233868	0.1236474	0.006199638
K562_Wang	PBMC_13_CD16.Mono	16598	56832	54592	40234	37994	-0.2250108	0.1180195	0.001952716
K562_Wang	PBMC_17_B	16698	56832	58277	40134	41579	-0.2335835	0.1213902	0.003276474
K562_Wang	PBMC_20_CD4.N1	16799	56832	60378	40033	43579	-0.2415158	0.1151734	-0.002178674
K562_Wang	PBMC_22_CD4.M	17494	56832	59146	39338	41652	-0.2235475	0.1161525	0.001672671
K562_Wang	PBMC_24_CD8.CM	17259	56832	59210	39573	41951	-0.2248091	0.1249101	0.008670553
K562_Wang	PBMC_25_NK	16966	56832	57699	39866	40733	-0.2241693	0.1260178	0.009172749
K562_Wang	Islets_beta	16974	56832	63734	39858	46760	-0.2606178	0.076296	-0.03760374
K562_Wang	Islets_alpha	16932	56832	65486	39900	48554	-0.2612678	0.08756114	-0.02762721
K562_Wang	Islets_delta	17433	56832	61673	39399	44240	-0.2331354	0.1109783	-0.004031884
K562_Wang	Islets_PP	16785	56832	63824	40047	47039	-0.2581326	0.09917055	-0.01801519
K562_Wang	Islets_acinar	19001	56832	66719	37831	47718	-0.2149252	0.1204446	0.005974783
K562_Wang	Islets_duct	18414	56832	63744	38418	45330	-0.2160609	0.1272159	0.01188191
K562_Wang	Islets_endothelial	18382	56832	64155	38450	45773	-0.2177953	0.1244898	0.00973363
K562_Wang	Islets_immune	19130	56832	67939	37702	48809	-0.2207899	0.11364	0.0003288407
K562_Wang	Islets_mesenchymal	19119	56832	62786	37713	43667	-0.1998431	0.1314556	0.01924517
K562_Wang	HCT116	21579	56832	64892	35253	43313	-0.119414	0.2026751	0.08890413
K562_Wang	WTC11_from_HPC_diff	18076	56832	58398	38756	40322	-0.2152033	0.1186526	0.006631532
K562_Wang	Jurkat	18366	56832	58783	38466	40417	-0.2055711	0.1246381	0.0118038
GM12878	GM12878	54448	54448	54448	0	0	1	1	1
GM12878	BMMC5_B	27105	54448	67427	27343	40322	0.01902772	0.2908743	0.1870841
GM12878	BMMC5_T	23583	54448	66240	30865	42657	-0.07044205	0.2219437	0.1142249
GM12878	BMMC5_Myeloid	22291	54448	66645	32157	44354	-0.1115065	0.1936011	0.08305635
GM12878	BMMC5_Dendritic	25035	54448	63327	29413	38292	-0.02938679	0.2509103	0.1450394
GM12878	BMMC5_Erythroid	19858	54448	65700	34590	45842	-0.1604311	0.1584674	0.04324866
GM12878	BMMC22_B1_B	27424	54448	63712	27024	36288	0.04808363	0.3153731	0.2122302
GM12878	BMMC22_CD4_pos_T_activated	23506	54448	67674	30942	44168	-0.06690236	0.2358656	0.1263387
GM12878	BMMC22_CD4_pos_T_naive	22469	54448	65164	31979	42695	-0.08505182	0.2224307	0.1115253
GM12878	BMMC22_CD8_pos_T	22733	54448	56554	31715	33821	-0.03968366	0.2576237	0.1487416
GM12878	BMMC22_CD8_pos_T_naive	20494	54448	63902	33954	43408	-0.1346757	0.1914555	0.07807982
GM12878	BMMC22_CD14_pos_Mono	21269	54448	64846	33179	43577	-0.1326895	0.1792059	0.06773362
GM12878	BMMC22_CD16_pos_Mono	21885	54448	61683	32563	39798	-0.09162835	0.222211	0.1096938
GM12878	BMMC22_cDC2	24426	54448	60955	30022	36529	-0.02189212	0.2679877	0.1594334
GM12878	BMMC22_Erythroblast	18311	54448	62295	36137	43984	-0.1842654	0.1479642	0.03150826
GM12878	BMMC22_G_M_prog	23508	54448	63921	30940	40413	-0.06787527	0.2298358	0.1205722
GM12878	BMMC22_HSC	22784	54448	64808	31664	42024	-0.08643003	0.2186549	0.1086548
GM12878	BMMC22_ID2_hi_myeloid_prog	12452	54448	35748	41996	23296	-0.2700965	0.0249722	-0.07784363
GM12878	BMMC22_ILC	20892	54448	56304	33556	35412	-0.0867831	0.2333316	0.1202915
GM12878	BMMC22_Lymph_prog	25203	54448	66487	29245	41284	-0.02758945	0.2590968	0.1525257
GM12878	BMMC22_MK_E_prog	21713	54448	63497	32735	41784	-0.1042583	0.2119775	0.09904646
GM12878	BMMC22_Naive_CD20_pos_B	25764	54448	63355	28684	37591	0.01011311	0.2941991	0.1879797
GM12878	BMMC22_NK	23142	54448	66621	31306	43479	-0.06989317	0.2404785	0.128785
GM12878	BMMC22_Normoblast	16525	54448	56020	37923	39495	-0.2180391	0.1296244	0.01330366
GM12878	BMMC22_pDC	23601	54448	61970	30847	38369	-0.06414055	0.2266462	0.1193629
GM12878	BMMC22_Plasma_cell	27615	54448	65478	26833	37863	0.04442543	0.3104282	0.2073347
GM12878	BMMC22_Proerythroblast	19619	54448	63281	34829	43662	-0.1602319	0.1678848	0.05227082
GM12878	BMMC22_Transitional_B	24476	54448	63246	29972	38770	-0.02949258	0.2633533	0.1555301
GM12878	PBMC5_B	27263	54448	61777	27185	34514	0.06052356	0.327517	0.2239922
GM12878	PBMC5_DC	22404	54448	54841	32044	32437	-0.04364937	0.2531811	0.1436139
GM12878	PBMC5_Mono	22325	54448	63455	32123	41130	-0.0903331	0.2175859	0.1063332
GM12878	PBMC5_NK	21626	54448	58922	32822	37296	-0.08039004	0.2352396	0.1235183
GM12878	PBMC5_T	22126	54448	59027	32322	36901	-0.0756375	0.2257166	0.1170361
GM12878	PBMC_10_cDC	23848	54448	55848	30600	32000	-0.008814182	0.2780924	0.1702769
GM12878	PBMC_11_CD14.Mono.1	19898	54448	59470	34550	39572	-0.1366398	0.1919967	0.07762625
GM12878	PBMC_12_CD14.Mono.2	20883	54448	59397	33565	38514	-0.1084045	0.2124724	0.09869363
GM12878	PBMC_13_CD16.Mono	20974	54448	54592	33474	33618	-0.08012396	0.2306136	0.1186473
GM12878	PBMC_17_B	26145	54448	58277	28303	32132	0.05500483	0.3289156	0.2244594
GM12878	PBMC_20_CD4.N1	20812	54448	60378	33636	39566	-0.1060691	0.2223774	0.108757
GM12878	PBMC_22_CD4.M	21803	54448	59146	32645	37343	-0.08000522	0.2282802	0.1181004
GM12878	PBMC_24_CD8.CM	22434	54448	59210	32014	36776	-0.05708657	0.2545667	0.1436506
GM12878	PBMC_25_NK	21402	54448	57699	33046	36297	-0.0783142	0.238061	0.1260157
GM12878	Islets_beta	15827	54448	63734	38621	47907	-0.2825166	0.05583599	-0.05795169
GM12878	Islets_alpha	15841	54448	65486	38607	49645	-0.2818931	0.0676473	-0.04761791
GM12878	Islets_delta	16297	54448	61673	38151	45376	-0.2553585	0.09064691	-0.02457346
GM12878	Islets_PP	15877	54448	63824	38571	47947	-0.2704223	0.08776619	-0.02933841
GM12878	Islets_acinar	17201	54448	66719	37247	49518	-0.2516828	0.08862086	-0.02666479
GM12878	Islets_duct	17206	54448	63744	37242	46538	-0.2368693	0.1093816	-0.006498834
GM12878	Islets_endothelial	17317	54448	64155	37131	46838	-0.23224	0.1146119	-0.00125996
GM12878	Islets_immune	21055	54448	67939	33393	46884	-0.1585723	0.158837	0.04817759
GM12878	Islets_mesenchymal	17183	54448	62786	37265	45603	-0.2410161	0.09899762	-0.01493104
GM12878	HCT116	18368	54448	64892	36080	46524	-0.1901166	0.1511537	0.03362087
GM12878	WTC11_from_HPC_diff	15242	54448	58398	39206	43156	-0.2838423	0.06589015	-0.04907187
GM12878	Jurkat	18949	54448	58783	35499	39834	-0.1699188	0.1575184	0.04459234
BMMC5_B	BMMC5_B	67427	67427	67427	0	0	1	1	1
BMMC5_B	BMMC5_T	31204	67427	66240	36223	35036	0.05896932	0.3409408	0.2321373
BMMC5_B	BMMC5_Myeloid	30661	67427	66645	36766	35984	0.04056203	0.328134	0.2189114
BMMC5_B	BMMC5_Dendritic	35480	67427	63327	31947	27847	0.1936354	0.4351959	0.3338881
BMMC5_B	BMMC5_Erythroid	24712	67427	65700	42715	40988	-0.1052559	0.2153906	0.09877017
BMMC5_B	BMMC22_B1_B	44738	67427	63712	22689	18974	0.4322269	0.5945659	0.5078668
BMMC5_B	BMMC22_CD4_pos_T_activated	30906	67427	67674	36521	36768	0.05255566	0.3475663	0.2367027
BMMC5_B	BMMC22_CD4_pos_T_naive	30353	67427	65164	37074	34811	0.05415072	0.3479899	0.2373055
BMMC5_B	BMMC22_CD8_pos_T	28845	67427	56554	38582	27709	0.07876526	0.3640561	0.255312
BMMC5_B	BMMC22_CD8_pos_T_naive	27717	67427	63902	39710	36185	-0.007523792	0.3061619	0.1929991
BMMC5_B	BMMC22_CD14_pos_Mono	28840	67427	64846	38587	36006	0.001323072	0.2987539	0.1884486
BMMC5_B	BMMC22_CD16_pos_Mono	28485	67427	61683	38942	33198	0.01047348	0.3057475	0.1965538
BMMC5_B	BMMC22_cDC2	31479	67427	60955	35948	29476	0.1018493	0.3691879	0.2644545
BMMC5_B	BMMC22_Erythroblast	22394	67427	62295	45033	39901	-0.151157	0.1813426	0.06478999
BMMC5_B	BMMC22_G_M_prog	32251	67427	63921	35176	31670	0.1016762	0.3725731	0.2666288
BMMC5_B	BMMC22_HSC	31795	67427	64808	35632	33013	0.08403096	0.3631587	0.2555447
BMMC5_B	BMMC22_ID2_hi_myeloid_prog	13137	67427	35748	54290	22611	-0.2822327	-0.008736779	-0.1054798
BMMC5_B	BMMC22_ILC	23941	67427	56304	43486	32363	-0.07386465	0.2471427	0.1347707
BMMC5_B	BMMC22_Lymph_prog	40649	67427	66487	26778	25838	0.2911885	0.4975712	0.4028579
BMMC5_B	BMMC22_MK_E_prog	27963	67427	63497	39464	35534	-0.004005407	0.3036029	0.1909409
BMMC5_B	BMMC22_Naive_CD20_pos_B	50454	67427	63355	16973	12901	0.5905218	0.6982459	0.6230452
BMMC5_B	BMMC22_NK	30447	67427	66621	36980	36174	0.05274572	0.3558088	0.2426612
BMMC5_B	BMMC22_Normoblast	18282	67427	56020	49145	37738	-0.2359658	0.1126022	-0.002177424
BMMC5_B	BMMC22_pDC	34122	67427	61970	33305	27848	0.1624996	0.4132479	0.3107188
BMMC5_B	BMMC22_Plasma_cell	31263	67427	65478	36164	34215	0.04829742	0.325473	0.2200557
BMMC5_B	BMMC22_Proerythroblast	24705	67427	63281	42722	38576	-0.08671507	0.2419728	0.1244914
BMMC5_B	BMMC22_Transitional_B	45138	67427	63246	22289	18108	0.4412935	0.5980218	0.5124901
BMMC5_B	PBMC5_B	40548	67427	61777	26879	21229	0.3167932	0.5058035	0.4145236
BMMC5_B	PBMC5_DC	26829	67427	54841	40598	28012	0.00882575	0.2900786	0.1850067
BMMC5_B	PBMC5_Mono	28311	67427	63455	39116	35144	-0.009817179	0.2859635	0.176263
BMMC5_B	PBMC5_NK	25454	67427	58922	41973	33468	-0.0524243	0.2614896	0.1504132
BMMC5_B	PBMC5_T	28412	67427	59027	39015	30615	0.02615392	0.3125798	0.2049898
BMMC5_B	PBMC_10_cDC	29128	67427	55848	38299	26720	0.06657314	0.3315994	0.2291463
BMMC5_B	PBMC_11_CD14.Mono.1	23781	67427	59470	43646	35689	-0.1066324	0.2153095	0.1032654
BMMC5_B	PBMC_12_CD14.Mono.2	25638	67427	59397	41789	33759	-0.04921384	0.2625635	0.1508062
BMMC5_B	PBMC_13_CD16.Mono	25421	67427	54592	42006	29171	-0.02493319	0.2692727	0.1618953
BMMC5_B	PBMC_17_B	37628	67427	58277	29799	20649	0.2765975	0.483051	0.3903323
BMMC5_B	PBMC_20_CD4.N1	25300	67427	60378	42127	35078	-0.06325021	0.2597697	0.1474751
BMMC5_B	PBMC_22_CD4.M	28359	67427	59146	39068	30787	0.03024915	0.3230275	0.2138739
BMMC5_B	PBMC_24_CD8.CM	27097	67427	59210	40330	32113	-0.006619619	0.2997361	0.1892916
BMMC5_B	PBMC_25_NK	25082	67427	57699	42345	32617	-0.05277483	0.2616409	0.1504702
BMMC5_B	Islets_beta	17761	67427	63734	49666	45973	-0.2837738	0.06679198	-0.04946861
BMMC5_B	Islets_alpha	17883	67427	65486	49544	47603	-0.2795474	0.0835905	-0.03471917
BMMC5_B	Islets_delta	18308	67427	61673	49119	43365	-0.2526722	0.1048827	-0.01280062
BMMC5_B	Islets_PP	17911	67427	63824	49516	45913	-0.2690143	0.1017341	-0.01810973
BMMC5_B	Islets_acinar	18862	67427	66719	48565	47857	-0.2609118	0.09730493	-0.02163735
BMMC5_B	Islets_duct	18606	67427	63744	48821	45138	-0.2506727	0.1123982	-0.007009365
BMMC5_B	Islets_endothelial	19128	67427	64155	48299	45027	-0.2484582	0.1068004	-0.01024307
BMMC5_B	Islets_immune	24549	67427	67939	42878	43390	-0.1445145	0.1759262	0.06485279
BMMC5_B	Islets_mesenchymal	18707	67427	62786	48720	44079	-0.2474506	0.1081289	-0.00912164
BMMC5_B	HCT116	18458	67427	64892	48969	46434	-0.2679453	0.08709792	-0.03076764
BMMC5_B	WTC11_from_HPC_diff	17504	67427	58398	49923	40894	-0.2576276	0.1041289	-0.0133831
BMMC5_B	Jurkat	21677	67427	58783	45750	37106	-0.1757964	0.1486117	0.037877
BMMC5_T	BMMC5_T	66240	66240	66240	0	0	1	1	1
BMMC5_T	BMMC5_Myeloid	25868	66240	66645	40372	40777	-0.08369566	0.2226706	0.110898
BMMC5_T	BMMC5_Dendritic	28612	66240	63327	37628	34715	0.02585378	0.3126368	0.2040655
BMMC5_T	BMMC5_Erythroid	25806	66240	65700	40434	39894	-0.08304983	0.2154686	0.1035824
BMMC5_T	BMMC22_B1_B	29869	66240	63712	36371	33843	0.05550781	0.3430573	0.2342989
BMMC5_T	BMMC22_CD4_pos_T_activated	50087	66240	67674	16153	17587	0.5838739	0.6968341	0.6220236
BMMC5_T	BMMC22_CD4_pos_T_naive	47412	66240	65164	18828	17752	0.5271062	0.6562033	0.5768731
BMMC5_T	BMMC22_CD8_pos_T	46142	66240	56554	20098	10412	0.6000755	0.7063342	0.6357689
BMMC5_T	BMMC22_CD8_pos_T_naive	36237	66240	63902	30003	27665	0.2210739	0.4508848	0.3532733
BMMC5_T	BMMC22_CD14_pos_Mono	24390	66240	64846	41850	40456	-0.1129628	0.2019555	0.08898882
BMMC5_T	BMMC22_CD16_pos_Mono	23741	66240	61683	42499	37942	-0.1012806	0.2194626	0.1060577
BMMC5_T	BMMC22_cDC2	25691	66240	60955	40549	35264	-0.03836387	0.2644759	0.154079
BMMC5_T	BMMC22_Erythroblast	23239	66240	62295	43001	39056	-0.1265235	0.187305	0.07441683
BMMC5_T	BMMC22_G_M_prog	26948	66240	63921	39292	36973	-0.03212725	0.2652801	0.1561361
BMMC5_T	BMMC22_HSC	28146	66240	64808	38094	36662	-0.003184442	0.2887734	0.180951
BMMC5_T	BMMC22_ID2_hi_myeloid_prog	11623	66240	35748	54617	24125	-0.3156153	-0.02857333	-0.1291688
BMMC5_T	BMMC22_ILC	29956	66240	56304	36284	26348	0.1014618	0.3583048	0.2583825
BMMC5_T	BMMC22_Lymph_prog	29467	66240	66487	36773	37020	0.01717538	0.302951	0.1955113
BMMC5_T	BMMC22_MK_E_prog	26302	66240	63497	39938	37195	-0.04754621	0.2548403	0.1447716
BMMC5_T	BMMC22_Naive_CD20_pos_B	29731	66240	63355	36509	33624	0.05748474	0.3474681	0.2378581
BMMC5_T	BMMC22_NK	39997	66240	66621	26243	26624	0.3045732	0.5117473	0.4176106
BMMC5_T	BMMC22_Normoblast	19186	66240	56020	47054	36834	-0.2010047	0.1332927	0.02100352
BMMC5_T	BMMC22_pDC	27579	66240	61970	38661	34391	0.003934246	0.2966584	0.1876333
BMMC5_T	BMMC22_Plasma_cell	28008	66240	65478	38232	37470	-0.02013993	0.2707782	0.1637687
BMMC5_T	BMMC22_Proerythroblast	24395	66240	63281	41845	38886	-0.095128	0.220007	0.1064789
BMMC5_T	BMMC22_Transitional_B	26138	66240	63246	40102	37108	-0.04257024	0.2684102	0.1563205
BMMC5_T	PBMC5_B	30070	66240	61777	36170	31707	0.07024641	0.3460631	0.240116
BMMC5_T	PBMC5_DC	22599	66240	54841	43641	32242	-0.09279618	0.2131458	0.1036255
BMMC5_T	PBMC5_Mono	25293	66240	63455	40947	38162	-0.0682392	0.2410081	0.1289927
BMMC5_T	PBMC5_NK	32685	66240	58922	33555	26237	0.1452734	0.3847546	0.2877421
BMMC5_T	PBMC5_T	43002	66240	59027	23238	16025	0.4456219	0.5893856	0.5080205
BMMC5_T	PBMC_10_cDC	23820	66240	55848	42420	32028	-0.06267235	0.237783	0.1291068
BMMC5_T	PBMC_11_CD14.Mono.1	19944	66240	59470	46296	39526	-0.1937952	0.1460347	0.03091957
BMMC5_T	PBMC_12_CD14.Mono.2	21501	66240	59397	44739	37896	-0.1494526	0.181739	0.06672691
BMMC5_T	PBMC_13_CD16.Mono	21819	66240	54592	44421	32773	-0.1078175	0.206129	0.09504505
BMMC5_T	PBMC_17_B	26281	66240	58277	39959	31996	-0.005521148	0.2968274	0.1871921
BMMC5_T	PBMC_20_CD4.N1	33019	66240	60378	33221	27359	0.1505239	0.3959983	0.2979906
BMMC5_T	PBMC_22_CD4.M	41739	66240	59146	24501	17407	0.4111634	0.5716996	0.486779
BMMC5_T	PBMC_24_CD8.CM	38500	66240	59210	27740	20710	0.3074456	0.4955949	0.4075777
BMMC5_T	PBMC_25_NK	32195	66240	57699	34045	25504	0.1417074	0.3810478	0.2843397
BMMC5_T	Islets_beta	18699	66240	63734	47541	45035	-0.2677465	0.06404239	-0.04844297
BMMC5_T	Islets_alpha	18341	66240	65486	47899	47145	-0.2729795	0.0731492	-0.04124088
BMMC5_T	Islets_delta	18877	66240	61673	47363	42796	-0.2421809	0.09797435	-0.01618289
BMMC5_T	Islets_PP	17877	66240	63824	48363	45947	-0.2726886	0.08350183	-0.03280215
BMMC5_T	Islets_acinar	19149	66240	66719	47091	47570	-0.2591112	0.08218532	-0.03288709
BMMC5_T	Islets_duct	18421	66240	63744	47819	45323	-0.2591546	0.09040304	-0.025424
BMMC5_T	Islets_endothelial	18794	66240	64155	47446	45361	-0.2552901	0.08937643	-0.02479155
BMMC5_T	Islets_immune	22141	66240	67939	44099	45798	-0.1950933	0.131292	0.01977532
BMMC5_T	Islets_mesenchymal	18496	66240	62786	47744	44290	-0.2570961	0.08560824	-0.02828363
BMMC5_T	HCT116	18965	66240	64892	47275	45927	-0.2542155	0.08705241	-0.02749844
BMMC5_T	WTC11_from_HPC_diff	17276	66240	58398	48964	41122	-0.2706286	0.0769728	-0.03704646
BMMC5_T	Jurkat	24040	66240	58783	42200	34743	-0.1106973	0.1869647	0.08129173
BMMC5_Myeloid	BMMC5_Myeloid	66645	66645	66645	0	0	1	1	1
BMMC5_Myeloid	BMMC5_Dendritic	37051	66645	63327	29594	26276	0.2297602	0.4485745	0.3514652
BMMC5_Myeloid	BMMC5_Erythroid	24356	66645	65700	42289	41344	-0.1115937	0.2051039	0.08853526
BMMC5_Myeloid	BMMC22_B1_B	27198	66645	63712	39447	36514	-0.02040679	0.2883236	0.1765744
BMMC5_Myeloid	BMMC22_CD4_pos_T_activated	25374	66645	67674	41271	42300	-0.08972872	0.2333158	0.1186978
BMMC5_Myeloid	BMMC22_CD4_pos_T_naive	24580	66645	65164	42065	40584	-0.09769273	0.2244497	0.1100256
BMMC5_Myeloid	BMMC22_CD8_pos_T	23748	66645	56554	42897	32806	-0.06914863	0.2433415	0.1314332
BMMC5_Myeloid	BMMC22_CD8_pos_T_naive	22637	66645	63902	44008	41265	-0.1384085	0.2003581	0.08390004
BMMC5_Myeloid	BMMC22_CD14_pos_Mono	57337	66645	64846	9308	7509	0.7709649	0.8139585	0.7600278
BMMC5_Myeloid	BMMC22_CD16_pos_Mono	41974	66645	61683	24671	19709	0.3640018	0.5348177	0.4475832
BMMC5_Myeloid	BMMC22_cDC2	38484	66645	60955	28161	22471	0.2786591	0.4748053	0.3822609
BMMC5_Myeloid	BMMC22_Erythroblast	21692	66645	62295	44953	40603	-0.162893	0.1685505	0.05175395
BMMC5_Myeloid	BMMC22_G_M_prog	40245	66645	63921	26400	23676	0.2918423	0.4817627	0.3900805
BMMC5_Myeloid	BMMC22_HSC	31262	66645	64808	35383	33546	0.06750341	0.3405276	0.234586
BMMC5_Myeloid	BMMC22_ID2_hi_myeloid_prog	16282	66645	35748	50363	19466	-0.2063577	0.01752052	-0.06970375
BMMC5_Myeloid	BMMC22_ILC	20337	66645	56304	46308	35967	-0.1724332	0.1636268	0.04970328
BMMC5_Myeloid	BMMC22_Lymph_prog	29022	66645	66487	37623	37465	-0.002099499	0.2902962	0.1808868
BMMC5_Myeloid	BMMC22_MK_E_prog	27284	66645	63497	39361	36213	-0.01687565	0.2880217	0.1756884
BMMC5_Myeloid	BMMC22_Naive_CD20_pos_B	29806	66645	63355	36839	33549	0.04184413	0.3293422	0.2210838
BMMC5_Myeloid	BMMC22_NK	26025	66645	66621	40620	40596	-0.06327412	0.2588897	0.14384
BMMC5_Myeloid	BMMC22_Normoblast	16835	66645	56020	49810	39185	-0.2745067	0.07515416	-0.03944615
BMMC5_Myeloid	BMMC22_pDC	30362	66645	61970	36283	31608	0.06627198	0.3413307	0.2348613
BMMC5_Myeloid	BMMC22_Plasma_cell	23525	66645	65478	43120	41953	-0.1355284	0.1933881	0.0792526
BMMC5_Myeloid	BMMC22_Proerythroblast	23909	66645	63281	42736	39372	-0.1011272	0.2277001	0.1098019
BMMC5_Myeloid	BMMC22_Transitional_B	26454	66645	63246	40191	36792	-0.04167306	0.269664	0.157136
BMMC5_Myeloid	PBMC5_B	27754	66645	61777	38891	34023	-0.007172162	0.2869452	0.1784764
BMMC5_Myeloid	PBMC5_DC	33356	66645	54841	33289	21485	0.1726635	0.3880608	0.2946144
BMMC5_Myeloid	PBMC5_Mono	43457	66645	63455	23188	19998	0.3622413	0.5187503	0.4332897
BMMC5_Myeloid	PBMC5_NK	21574	66645	58922	45071	37348	-0.152779	0.179084	0.0657613
BMMC5_Myeloid	PBMC5_T	23174	66645	59027	43471	35853	-0.1140231	0.1997902	0.08868324
BMMC5_Myeloid	PBMC_10_cDC	34289	66645	55848	32356	21559	0.1881314	0.3968131	0.304377
BMMC5_Myeloid	PBMC_11_CD14.Mono.1	36539	66645	59470	30106	22931	0.2055405	0.4134382	0.3215921
BMMC5_Myeloid	PBMC_12_CD14.Mono.2	41034	66645	59397	25611	18363	0.3455467	0.5157404	0.4290713
BMMC5_Myeloid	PBMC_13_CD16.Mono	34250	66645	54592	32395	20342	0.1938264	0.3999699	0.3084761
BMMC5_Myeloid	PBMC_17_B	23888	66645	58277	42757	34389	-0.08324459	0.2356529	0.123894
BMMC5_Myeloid	PBMC_20_CD4.N1	20349	66645	60378	46296	40029	-0.194034	0.1504261	0.03552383
BMMC5_Myeloid	PBMC_22_CD4.M	23062	66645	59146	43583	36084	-0.1134881	0.2065423	0.09384437
BMMC5_Myeloid	PBMC_24_CD8.CM	21925	66645	59210	44720	37285	-0.1437008	0.1880998	0.07454013
BMMC5_Myeloid	PBMC_25_NK	21291	66645	57699	45354	36408	-0.1518675	0.1804271	0.0669256
BMMC5_Myeloid	Islets_beta	17892	66645	63734	48753	45842	-0.2775811	0.06705749	-0.04874468
BMMC5_Myeloid	Islets_alpha	18103	66645	65486	48542	47383	-0.2699756	0.08707531	-0.03053784
BMMC5_Myeloid	Islets_delta	18362	66645	61673	48283	43311	-0.2468131	0.105602	-0.01165084
BMMC5_Myeloid	Islets_PP	17489	66645	63824	49156	46335	-0.275411	0.09204891	-0.02739781
BMMC5_Myeloid	Islets_acinar	19752	66645	66719	46893	46967	-0.2354631	0.1129685	-0.004963213
BMMC5_Myeloid	Islets_duct	19363	66645	63744	47282	44381	-0.2254358	0.1293713	0.01086068
BMMC5_Myeloid	Islets_endothelial	19351	66645	64155	47294	44804	-0.2406714	0.1066963	-0.009167128
BMMC5_Myeloid	Islets_immune	28409	66645	67939	38236	39530	-0.06187943	0.2212483	0.1169206
BMMC5_Myeloid	Islets_mesenchymal	20388	66645	62786	46257	42398	-0.2064252	0.1322969	0.01764482
BMMC5_Myeloid	HCT116	18500	66645	64892	48145	46392	-0.2674897	0.0792109	-0.03707223
BMMC5_Myeloid	WTC11_from_HPC_diff	17240	66645	58398	49405	41158	-0.2610489	0.09876023	-0.0190872
BMMC5_Myeloid	Jurkat	18788	66645	58783	47857	39995	-0.2630463	0.06467177	-0.04574284
BMMC5_Dendritic	BMMC5_Dendritic	63327	63327	63327	0	0	1	1	1
BMMC5_Dendritic	BMMC5_Erythroid	24503	63327	65700	38824	41197	-0.08646448	0.2255228	0.1103983
BMMC5_Dendritic	BMMC22_B1_B	31657	63327	63712	31670	32055	0.1213179	0.3907585	0.2855258
BMMC5_Dendritic	BMMC22_CD4_pos_T_activated	28580	63327	67674	34747	39094	0.02696002	0.3252239	0.2145344
BMMC5_Dendritic	BMMC22_CD4_pos_T_naive	27992	63327	65164	35335	37172	0.02733114	0.3263461	0.2154018
BMMC5_Dendritic	BMMC22_CD8_pos_T	26725	63327	56554	36602	29829	0.04615559	0.3380845	0.2291985
BMMC5_Dendritic	BMMC22_CD8_pos_T_naive	26092	63327	63902	37235	37810	-0.02067891	0.2950535	0.1819357
BMMC5_Dendritic	BMMC22_CD14_pos_Mono	34514	63327	64846	28813	30332	0.169476	0.4060426	0.3065607
BMMC5_Dendritic	BMMC22_CD16_pos_Mono	33352	63327	61683	29975	28331	0.1501867	0.3895066	0.2904048
BMMC5_Dendritic	BMMC22_cDC2	44359	63327	60955	18968	16596	0.4562925	0.5890624	0.5076643
BMMC5_Dendritic	BMMC22_Erythroblast	21724	63327	62295	41603	40571	-0.1412431	0.1874066	0.07172828
BMMC5_Dendritic	BMMC22_G_M_prog	39707	63327	63921	23620	24214	0.3093139	0.4983285	0.4066858
BMMC5_Dendritic	BMMC22_HSC	34520	63327	64808	28807	30288	0.1800135	0.4224505	0.3213992
BMMC5_Dendritic	BMMC22_ID2_hi_myeloid_prog	15100	63327	35748	48227	20648	-0.2361689	0.01024204	-0.08087712
BMMC5_Dendritic	BMMC22_ILC	23305	63327	56304	40022	32999	-0.07660822	0.2382157	0.1275524
BMMC5_Dendritic	BMMC22_Lymph_prog	34717	63327	66487	28610	31770	0.1694858	0.4130791	0.3114435
BMMC5_Dendritic	BMMC22_MK_E_prog	29461	63327	63497	33866	34036	0.0568497	0.3417469	0.2326445
BMMC5_Dendritic	BMMC22_Naive_CD20_pos_B	33851	63327	63355	29476	29504	0.1805988	0.4294417	0.3276027
BMMC5_Dendritic	BMMC22_NK	28490	63327	66621	34837	38131	0.03355724	0.3360103	0.2243036
BMMC5_Dendritic	BMMC22_Normoblast	17861	63327	56020	45466	38159	-0.2375348	0.1033534	-0.009523761
BMMC5_Dendritic	BMMC22_pDC	47046	63327	61970	16281	14924	0.5405538	0.6551882	0.5776056
BMMC5_Dendritic	BMMC22_Plasma_cell	27840	63327	65478	35487	37638	-0.01422039	0.2775726	0.1699607
BMMC5_Dendritic	BMMC22_Proerythroblast	25046	63327	63281	38281	38235	-0.05255522	0.2660046	0.1501015
BMMC5_Dendritic	BMMC22_Transitional_B	32019	63327	63246	31308	31227	0.1263144	0.3914628	0.2864541
BMMC5_Dendritic	PBMC5_B	32258	63327	61777	31069	29519	0.1332412	0.3844601	0.2832888
BMMC5_Dendritic	PBMC5_DC	33819	63327	54841	29508	21022	0.1933464	0.3994509	0.3076076
BMMC5_Dendritic	PBMC5_Mono	33971	63327	63455	29356	29484	0.1535386	0.3863283	0.2881723
BMMC5_Dendritic	PBMC5_NK	24584	63327	58922	38743	34338	-0.05599973	0.252642	0.1430577
BMMC5_Dendritic	PBMC5_T	25932	63327	59027	37395	33095	-0.01086179	0.2837113	0.175756
BMMC5_Dendritic	PBMC_10_cDC	34918	63327	55848	28409	20930	0.2206949	0.419623	0.3285865
BMMC5_Dendritic	PBMC_11_CD14.Mono.1	28911	63327	59470	34416	30559	0.03822196	0.3069526	0.2048373
BMMC5_Dendritic	PBMC_12_CD14.Mono.2	31166	63327	59397	32161	28231	0.1111059	0.3634448	0.2628359
BMMC5_Dendritic	PBMC_13_CD16.Mono	30098	63327	54592	33229	24494	0.1060985	0.3467643	0.249167
BMMC5_Dendritic	PBMC_17_B	28271	63327	58277	35056	30006	0.05730574	0.339835	0.2342074
BMMC5_Dendritic	PBMC_20_CD4.N1	23602	63327	60378	39725	36776	-0.08369385	0.2395399	0.1279183
BMMC5_Dendritic	PBMC_22_CD4.M	25866	63327	59146	37461	33280	-0.006203748	0.2956108	0.1857578
BMMC5_Dendritic	PBMC_24_CD8.CM	25267	63327	59210	38060	33943	-0.02997998	0.2786337	0.1686727
BMMC5_Dendritic	PBMC_25_NK	24195	63327	57699	39132	33504	-0.0579094	0.251651	0.1419685
BMMC5_Dendritic	Islets_beta	17400	63327	63734	45927	46334	-0.2807409	0.06408462	-0.05090177
BMMC5_Dendritic	Islets_alpha	17593	63327	65486	45734	47893	-0.2704875	0.0870969	-0.0299576
BMMC5_Dendritic	Islets_delta	18152	63327	61673	45175	43521	-0.2409187	0.1108531	-0.00567908
BMMC5_Dendritic	Islets_PP	17663	63327	63824	45664	46161	-0.2602577	0.1045184	-0.01405324
BMMC5_Dendritic	Islets_acinar	18974	63327	66719	44353	47745	-0.24291	0.1068029	-0.01055326
BMMC5_Dendritic	Islets_duct	19084	63327	63744	44243	44660	-0.2223361	0.1322937	0.01437083
BMMC5_Dendritic	Islets_endothelial	19544	63327	64155	43783	44611	-0.222523	0.1222695	0.007124868
BMMC5_Dendritic	Islets_immune	27499	63327	67939	35828	40440	-0.0660619	0.218834	0.1142755
BMMC5_Dendritic	Islets_mesenchymal	19523	63327	62786	43804	43263	-0.2175028	0.1252545	0.01033446
BMMC5_Dendritic	HCT116	18526	63327	64892	44801	46366	-0.2492202	0.09740905	-0.01870702
BMMC5_Dendritic	WTC11_from_HPC_diff	17805	63327	58398	45522	40593	-0.2339406	0.1229276	0.00601453
BMMC5_Dendritic	Jurkat	21616	63327	58783	41711	37167	-0.1665097	0.1477584	0.03903484
BMMC5_Erythroid	BMMC5_Erythroid	65700	65700	65700	0	0	1	1	1
BMMC5_Erythroid	BMMC22_B1_B	22828	65700	63712	42872	40884	-0.1295178	0.201569	0.08401229
BMMC5_Erythroid	BMMC22_CD4_pos_T_activated	25327	65700	67674	40373	42347	-0.08950247	0.2247185	0.1102259
BMMC5_Erythroid	BMMC22_CD4_pos_T_naive	25083	65700	65164	40617	40081	-0.08834361	0.2217904	0.1077494
BMMC5_Erythroid	BMMC22_CD8_pos_T	23458	65700	56554	42242	33096	-0.06985277	0.2378253	0.1248024
BMMC5_Erythroid	BMMC22_CD8_pos_T_naive	23093	65700	63902	42607	40809	-0.1292625	0.1958502	0.08083453
BMMC5_Erythroid	BMMC22_CD14_pos_Mono	22948	65700	64846	42752	41898	-0.1420518	0.1812572	0.0641696
BMMC5_Erythroid	BMMC22_CD16_pos_Mono	21373	65700	61683	44327	40310	-0.1557139	0.179446	0.06107256
BMMC5_Erythroid	BMMC22_cDC2	22744	65700	60955	42956	38211	-0.1112349	0.2117791	0.09517543
BMMC5_Erythroid	BMMC22_Erythroblast	45613	65700	62295	20087	16682	0.5114285	0.6445143	0.5636546
BMMC5_Erythroid	BMMC22_G_M_prog	25193	65700	63921	40507	38728	-0.07485327	0.2333934	0.1193937
BMMC5_Erythroid	BMMC22_HSC	26668	65700	64808	39032	38140	-0.0472776	0.2523416	0.1406195
BMMC5_Erythroid	BMMC22_ID2_hi_myeloid_prog	10761	65700	35748	54939	24987	-0.3508716	-0.06376736	-0.1657545
BMMC5_Erythroid	BMMC22_ILC	20629	65700	56304	45071	35675	-0.1526869	0.1761491	0.06122554
BMMC5_Erythroid	BMMC22_Lymph_prog	25391	65700	66487	40309	41096	-0.08007232	0.2330085	0.1182168
BMMC5_Erythroid	BMMC22_MK_E_prog	34361	65700	63497	31339	29136	0.1538528	0.3869117	0.2882807
BMMC5_Erythroid	BMMC22_Naive_CD20_pos_B	23675	65700	63355	42025	39680	-0.1048568	0.2212256	0.10412
BMMC5_Erythroid	BMMC22_NK	25223	65700	66621	40477	41398	-0.07891462	0.2416106	0.125137
BMMC5_Erythroid	BMMC22_Normoblast	26511	65700	56020	39189	29509	-0.004521658	0.2743473	0.1706349
BMMC5_Erythroid	BMMC22_pDC	23518	65700	61970	42182	38452	-0.1067537	0.2104146	0.09522691
BMMC5_Erythroid	BMMC22_Plasma_cell	22210	65700	65478	43490	43268	-0.1589425	0.1713237	0.05512332
BMMC5_Erythroid	BMMC22_Proerythroblast	47580	65700	63281	18120	15701	0.5276382	0.6414705	0.5642315
BMMC5_Erythroid	BMMC22_Transitional_B	22874	65700	63246	42826	40372	-0.1245714	0.2065682	0.08865364
BMMC5_Erythroid	PBMC5_B	22601	65700	61777	43099	39176	-0.12872	0.198551	0.08187802
BMMC5_Erythroid	PBMC5_DC	19853	65700	54841	45847	34988	-0.1649217	0.1600821	0.04475755
BMMC5_Erythroid	PBMC5_Mono	21438	65700	63455	44262	42017	-0.1672149	0.1638966	0.04602516
BMMC5_Erythroid	PBMC5_NK	21621	65700	58922	44079	37301	-0.1381155	0.1895066	0.07449645
BMMC5_Erythroid	PBMC5_T	23393	65700	59027	42307	35634	-0.1008593	0.204196	0.09276651
BMMC5_Erythroid	PBMC_10_cDC	20548	65700	55848	45152	35300	-0.1500099	0.1732354	0.05797572
BMMC5_Erythroid	PBMC_11_CD14.Mono.1	18336	65700	59470	47364	41134	-0.23378	0.1130695	-0.005583039
BMMC5_Erythroid	PBMC_12_CD14.Mono.2	19601	65700	59397	46099	39796	-0.1928901	0.1485104	0.02934379
BMMC5_Erythroid	PBMC_13_CD16.Mono	19047	65700	54592	46653	35545	-0.1812764	0.1513785	0.03468685
BMMC5_Erythroid	PBMC_17_B	20769	65700	58277	44931	37508	-0.1530114	0.1835809	0.06632465
BMMC5_Erythroid	PBMC_20_CD4.N1	21010	65700	60378	44690	39368	-0.1665816	0.169163	0.05366876
BMMC5_Erythroid	PBMC_22_CD4.M	23444	65700	59146	42256	35702	-0.09579866	0.2142779	0.101404
BMMC5_Erythroid	PBMC_24_CD8.CM	22214	65700	59210	43486	36996	-0.1229277	0.2028099	0.0880412
BMMC5_Erythroid	PBMC_25_NK	21389	65700	57699	44311	36310	-0.1373008	0.1896195	0.07478196
BMMC5_Erythroid	Islets_beta	18365	65700	63734	47335	45369	-0.2644536	0.06912267	-0.04576833
BMMC5_Erythroid	Islets_alpha	18328	65700	65486	47372	47158	-0.2623304	0.08511121	-0.03173471
BMMC5_Erythroid	Islets_delta	18715	65700	61673	46985	42958	-0.2368765	0.1034552	-0.01280071
BMMC5_Erythroid	Islets_PP	17915	65700	63824	47785	45909	-0.2661917	0.08868777	-0.02936712
BMMC5_Erythroid	Islets_acinar	19620	65700	66719	46080	47099	-0.2412503	0.09661542	-0.01998496
BMMC5_Erythroid	Islets_duct	18887	65700	63744	46813	44857	-0.2395296	0.1080312	-0.009863692
BMMC5_Erythroid	Islets_endothelial	18653	65700	64155	47047	45502	-0.2532909	0.08973093	-0.02621607
BMMC5_Erythroid	Islets_immune	20738	65700	67939	44962	47201	-0.2257997	0.1055639	-0.008674338
BMMC5_Erythroid	Islets_mesenchymal	18671	65700	62786	47029	44115	-0.2456836	0.09532945	-0.02049573
BMMC5_Erythroid	HCT116	19400	65700	64892	46300	45492	-0.2416394	0.09361965	-0.02222293
BMMC5_Erythroid	WTC11_from_HPC_diff	17673	65700	58398	48027	40725	-0.2594521	0.08191781	-0.03288171
BMMC5_Erythroid	Jurkat	20916	65700	58783	44784	37867	-0.1896833	0.1257292	0.01457513
BMMC22_B1_B	BMMC22_B1_B	63712	63712	63712	0	0	1	1	1
BMMC22_B1_B	BMMC22_CD4_pos_T_activated	30442	63712	67674	33270	37232	0.06942228	0.3638702	0.2535407
BMMC22_B1_B	BMMC22_CD4_pos_T_naive	29497	63712	65164	34215	35667	0.0589731	0.3555358	0.2446304
BMMC22_B1_B	BMMC22_CD8_pos_T	28477	63712	56554	35235	28077	0.09142252	0.3762718	0.2681224
BMMC22_B1_B	BMMC22_CD8_pos_T_naive	27450	63712	63902	36262	36452	0.01087332	0.3256861	0.2119802
BMMC22_B1_B	BMMC22_CD14_pos_Mono	25841	63712	64846	37871	39005	-0.04746532	0.2695824	0.1565639
BMMC22_B1_B	BMMC22_CD16_pos_Mono	26972	63712	61683	36740	34711	0.002079196	0.3089132	0.1975262
BMMC22_B1_B	BMMC22_cDC2	29330	63712	60955	34382	31625	0.07148183	0.3548071	0.2473943
BMMC22_B1_B	BMMC22_Erythroblast	21190	63712	62295	42522	41105	-0.1571566	0.1830295	0.06533358
BMMC22_B1_B	BMMC22_G_M_prog	28784	63712	63921	34928	35137	0.03789981	0.3323738	0.2232216
BMMC22_B1_B	BMMC22_HSC	28506	63712	64808	35206	36302	0.02170943	0.3216371	0.2117252
BMMC22_B1_B	BMMC22_ID2_hi_myeloid_prog	12678	63712	35748	51034	23070	-0.2899595	-0.00490135	-0.1035398
BMMC22_B1_B	BMMC22_ILC	24323	63712	56304	39389	31981	-0.04150163	0.2760104	0.1639187
BMMC22_B1_B	BMMC22_Lymph_prog	33747	63712	66487	29965	32740	0.140792	0.3981414	0.2957123
BMMC22_B1_B	BMMC22_MK_E_prog	25751	63712	63497	37961	37746	-0.03881235	0.2822644	0.1677929
BMMC22_B1_B	BMMC22_Naive_CD20_pos_B	41457	63712	63355	22255	21898	0.3793335	0.5623802	0.4719009
BMMC22_B1_B	BMMC22_NK	29074	63712	66621	34638	37547	0.04446237	0.3526961	0.2394024
BMMC22_B1_B	BMMC22_Normoblast	18389	63712	56020	45323	37631	-0.2138657	0.1368036	0.02122752
BMMC22_B1_B	BMMC22_pDC	30561	63712	61970	33151	31409	0.09807945	0.3748063	0.2685408
BMMC22_B1_B	BMMC22_Plasma_cell	32687	63712	65478	31025	32791	0.114888	0.3768276	0.2734858
BMMC22_B1_B	BMMC22_Proerythroblast	22985	63712	63281	40727	40296	-0.1078874	0.2313441	0.1129156
BMMC22_B1_B	BMMC22_Transitional_B	34370	63712	63246	29342	28876	0.188834	0.4381917	0.3366533
BMMC22_B1_B	PBMC5_B	40709	63712	61777	23003	21068	0.3471706	0.523726	0.4345269
BMMC22_B1_B	PBMC5_DC	25628	63712	54841	38084	29213	-0.0007426917	0.2907718	0.1834276
BMMC22_B1_B	PBMC5_Mono	26198	63712	63455	37514	37257	-0.03479489	0.2751158	0.1633897
BMMC22_B1_B	PBMC5_NK	25519	63712	58922	38193	33403	-0.02992274	0.2817029	0.1707706
BMMC22_B1_B	PBMC5_T	27550	63712	59027	36162	31477	0.0273999	0.3174599	0.2096431
BMMC22_B1_B	PBMC_10_cDC	28015	63712	55848	35697	27833	0.06160253	0.3360069	0.2312773
BMMC22_B1_B	PBMC_11_CD14.Mono.1	22599	63712	59470	41113	36871	-0.1100848	0.2231053	0.108561
BMMC22_B1_B	PBMC_12_CD14.Mono.2	23836	63712	59397	39876	35561	-0.07080038	0.2550669	0.1407835
BMMC22_B1_B	PBMC_13_CD16.Mono	24494	63712	54592	39218	30098	-0.0245473	0.2790318	0.1694864
BMMC22_B1_B	PBMC_17_B	38914	63712	58277	24798	19363	0.3380497	0.522439	0.4331212
BMMC22_B1_B	PBMC_20_CD4.N1	25894	63712	60378	37818	34484	-0.02325263	0.2936752	0.1817183
BMMC22_B1_B	PBMC_22_CD4.M	27531	63712	59146	36181	31615	0.03530179	0.3319415	0.2224774
BMMC22_B1_B	PBMC_24_CD8.CM	27202	63712	59210	36510	32008	0.01750315	0.3191363	0.2094203
BMMC22_B1_B	PBMC_25_NK	25107	63712	57699	38605	32592	-0.03339626	0.278734	0.1678123
BMMC22_B1_B	Islets_beta	16824	63712	63734	46888	46910	-0.2901627	0.06690507	-0.04987077
BMMC22_B1_B	Islets_alpha	16785	63712	65486	46927	48701	-0.2890052	0.08118339	-0.03753835
BMMC22_B1_B	Islets_delta	17362	63712	61673	46350	44311	-0.2578422	0.1069396	-0.01148147
BMMC22_B1_B	Islets_PP	17142	63712	63824	46570	46682	-0.2742515	0.1009946	-0.01913636
BMMC22_B1_B	Islets_acinar	17978	63712	66719	45734	48741	-0.2646495	0.09871209	-0.02062923
BMMC22_B1_B	Islets_duct	17868	63712	63744	45844	45876	-0.2528934	0.115438	-0.004401949
BMMC22_B1_B	Islets_endothelial	18417	63712	64155	45295	45738	-0.2451394	0.1173186	-0.001116831
BMMC22_B1_B	Islets_immune	23417	63712	67939	40295	44522	-0.1512215	0.1756041	0.06349704
BMMC22_B1_B	Islets_mesenchymal	17678	63712	62786	46034	45108	-0.2605318	0.1008904	-0.01660556
BMMC22_B1_B	HCT116	18084	63712	64892	45628	46808	-0.2537172	0.1073777	-0.01170742
BMMC22_B1_B	WTC11_from_HPC_diff	16648	63712	58398	47064	41750	-0.2658915	0.1022908	-0.01586882
BMMC22_B1_B	Jurkat	20095	63712	58783	43617	38688	-0.1940741	0.1424106	0.02961513
BMMC22_CD4_pos_T_activated	BMMC22_CD4_pos_T_activated	67674	67674	67674	0	0	1	1	1
BMMC22_CD4_pos_T_activated	BMMC22_CD4_pos_T_naive	44957	67674	65164	22717	20207	0.4551927	0.619575	0.5334746
BMMC22_CD4_pos_T_activated	BMMC22_CD8_pos_T	40809	67674	56554	26865	15745	0.4376749	0.6051506	0.5201726
BMMC22_CD4_pos_T_activated	BMMC22_CD8_pos_T_naive	36233	67674	63902	31441	27669	0.2183123	0.4591519	0.3592569
BMMC22_CD4_pos_T_activated	BMMC22_CD14_pos_Mono	24030	67674	64846	43644	40816	-0.116665	0.2138247	0.09810565
BMMC22_CD4_pos_T_activated	BMMC22_CD16_pos_Mono	23860	67674	61683	43814	37823	-0.09783333	0.2328182	0.1173154
BMMC22_CD4_pos_T_activated	BMMC22_cDC2	25964	67674	60955	41710	34991	-0.02835308	0.2839119	0.1716066
BMMC22_CD4_pos_T_activated	BMMC22_Erythroblast	23208	67674	62295	44466	39087	-0.124109	0.2022568	0.08698126
BMMC22_CD4_pos_T_activated	BMMC22_G_M_prog	26991	67674	63921	40683	36930	-0.02787756	0.2806467	0.1693025
BMMC22_CD4_pos_T_activated	BMMC22_HSC	28381	67674	64808	39293	36427	0.0005668025	0.3022984	0.1925849
BMMC22_CD4_pos_T_activated	BMMC22_ID2_hi_myeloid_prog	11637	67674	35748	56037	24111	-0.3119701	-0.01851411	-0.1203403
BMMC22_CD4_pos_T_activated	BMMC22_ILC	29747	67674	56304	37927	26557	0.09344768	0.3636746	0.2607559
BMMC22_CD4_pos_T_activated	BMMC22_Lymph_prog	29532	67674	66487	38142	36955	0.01985987	0.3168108	0.2073559
BMMC22_CD4_pos_T_activated	BMMC22_MK_E_prog	26348	67674	63497	41326	37149	-0.04446653	0.269963	0.157539
BMMC22_CD4_pos_T_activated	BMMC22_Naive_CD20_pos_B	29905	67674	63355	37769	33450	0.06149112	0.3603681	0.2490711
BMMC22_CD4_pos_T_activated	BMMC22_NK	38399	67674	66621	29275	28222	0.2551938	0.4878564	0.3886599
BMMC22_CD4_pos_T_activated	BMMC22_Normoblast	19479	67674	56020	48195	36541	-0.1935615	0.1484728	0.03467201
BMMC22_CD4_pos_T_activated	BMMC22_pDC	27742	67674	61970	39932	34228	0.01128136	0.3145767	0.2035133
BMMC22_CD4_pos_T_activated	BMMC22_Plasma_cell	28873	67674	65478	38801	36605	0.0002965253	0.2971385	0.1886005
BMMC22_CD4_pos_T_activated	BMMC22_Proerythroblast	24492	67674	63281	43182	38789	-0.09098385	0.2350529	0.1194868
BMMC22_CD4_pos_T_activated	BMMC22_Transitional_B	26380	67674	63246	41294	36866	-0.03570229	0.28397	0.1702623
BMMC22_CD4_pos_T_activated	PBMC5_B	30568	67674	61777	37106	31209	0.08053799	0.3633017	0.2557818
BMMC22_CD4_pos_T_activated	PBMC5_DC	22809	67674	54841	44865	32032	-0.08157385	0.2337561	0.1223001
BMMC22_CD4_pos_T_activated	PBMC5_Mono	25030	67674	63455	42644	38425	-0.07701991	0.2442234	0.1302961
BMMC22_CD4_pos_T_activated	PBMC5_NK	32413	67674	58922	35261	26509	0.1357662	0.3877092	0.2879542
BMMC22_CD4_pos_T_activated	PBMC5_T	41791	67674	59027	25883	17236	0.409971	0.5719228	0.4878338
BMMC22_CD4_pos_T_activated	PBMC_10_cDC	24084	67674	55848	43590	31764	-0.05004757	0.2595052	0.1488463
BMMC22_CD4_pos_T_activated	PBMC_11_CD14.Mono.1	20171	67674	59470	47503	39299	-0.1887708	0.1596719	0.04252589
BMMC22_CD4_pos_T_activated	PBMC_12_CD14.Mono.2	21531	67674	59397	46143	37866	-0.1467972	0.1949423	0.07774378
BMMC22_CD4_pos_T_activated	PBMC_13_CD16.Mono	21985	67674	54592	45689	32607	-0.1010879	0.2223875	0.1092817
BMMC22_CD4_pos_T_activated	PBMC_17_B	26755	67674	58277	40919	31522	0.006777592	0.3158603	0.2044304
BMMC22_CD4_pos_T_activated	PBMC_20_CD4.N1	34468	67674	60378	33206	25910	0.1791571	0.4219821	0.3234113
BMMC22_CD4_pos_T_activated	PBMC_22_CD4.M	41285	67674	59146	26389	17861	0.3982606	0.5710639	0.4843168
BMMC22_CD4_pos_T_activated	PBMC_24_CD8.CM	38443	67674	59210	29231	20767	0.3021923	0.5005553	0.4098389
BMMC22_CD4_pos_T_activated	PBMC_25_NK	31963	67674	57699	35711	25736	0.1340198	0.3854969	0.2860633
BMMC22_CD4_pos_T_activated	Islets_beta	18242	67674	63734	49432	45492	-0.2733878	0.07265471	-0.04231406
BMMC22_CD4_pos_T_activated	Islets_alpha	18025	67674	65486	49649	47461	-0.2770645	0.0829437	-0.03402888
BMMC22_CD4_pos_T_activated	Islets_delta	18701	67674	61673	48973	42972	-0.2435869	0.1082804	-0.00806401
BMMC22_CD4_pos_T_activated	Islets_PP	18094	67674	63824	49580	45730	-0.2660312	0.1000887	-0.01837995
BMMC22_CD4_pos_T_activated	Islets_acinar	19131	67674	66719	48543	47588	-0.2576775	0.09492209	-0.022173
BMMC22_CD4_pos_T_activated	Islets_duct	18639	67674	63744	49035	45105	-0.2502406	0.1097169	-0.008363455
BMMC22_CD4_pos_T_activated	Islets_endothelial	19287	67674	64155	48387	44868	-0.2409353	0.1125683	-0.003785605
BMMC22_CD4_pos_T_activated	Islets_immune	22468	67674	67939	45206	45471	-0.189321	0.1448829	0.03178869
BMMC22_CD4_pos_T_activated	Islets_mesenchymal	18621	67674	62786	49053	44165	-0.2519428	0.1000447	-0.01553869
BMMC22_CD4_pos_T_activated	HCT116	19337	67674	64892	48337	45555	-0.2425233	0.1082515	-0.008467385
BMMC22_CD4_pos_T_activated	WTC11_from_HPC_diff	17288	67674	58398	50386	41110	-0.2673259	0.09087182	-0.02515878
BMMC22_CD4_pos_T_activated	Jurkat	24134	67674	58783	43540	34649	-0.1057739	0.2028968	0.09485415
BMMC22_CD4_pos_T_naive	BMMC22_CD4_pos_T_naive	65164	65164	65164	0	0	1	1	1
BMMC22_CD4_pos_T_naive	BMMC22_CD8_pos_T	37745	65164	56554	27419	18809	0.3665917	0.5578213	0.4669411
BMMC22_CD4_pos_T_naive	BMMC22_CD8_pos_T_naive	37929	65164	63902	27235	25973	0.2879272	0.5076797	0.4111991
BMMC22_CD4_pos_T_naive	BMMC22_CD14_pos_Mono	23247	65164	64846	41917	41599	-0.1243863	0.2055686	0.08992131
BMMC22_CD4_pos_T_naive	BMMC22_CD16_pos_Mono	23159	65164	61683	42005	38524	-0.1033885	0.2275455	0.1119532
BMMC22_CD4_pos_T_naive	BMMC22_cDC2	25169	65164	60955	39995	35786	-0.03663281	0.2777641	0.1647641
BMMC22_CD4_pos_T_naive	BMMC22_Erythroblast	23106	65164	62295	42058	39189	-0.1205076	0.2001437	0.08558008
BMMC22_CD4_pos_T_naive	BMMC22_G_M_prog	26423	65164	63921	38741	37498	-0.03080551	0.2769914	0.1657649
BMMC22_CD4_pos_T_naive	BMMC22_HSC	28089	65164	64808	37075	36719	0.005381993	0.3045472	0.1950046
BMMC22_CD4_pos_T_naive	BMMC22_ID2_hi_myeloid_prog	11414	65164	35748	53750	24334	-0.3162688	-0.02078478	-0.1231556
BMMC22_CD4_pos_T_naive	BMMC22_ILC	28292	65164	56304	36872	28012	0.06941977	0.3467536	0.2422581
BMMC22_CD4_pos_T_naive	BMMC22_Lymph_prog	29157	65164	66487	36007	37330	0.02146597	0.3156319	0.2066839
BMMC22_CD4_pos_T_naive	BMMC22_MK_E_prog	26059	65164	63497	39105	37438	-0.03950019	0.2720843	0.1598352
BMMC22_CD4_pos_T_naive	BMMC22_Naive_CD20_pos_B	29414	65164	63355	35750	33941	0.06608467	0.3645547	0.2530209
BMMC22_CD4_pos_T_naive	BMMC22_NK	36051	65164	66621	29113	30570	0.2115906	0.4569298	0.3553922
BMMC22_CD4_pos_T_naive	BMMC22_Normoblast	19453	65164	56020	45711	36567	-0.1864214	0.1524629	0.0384757
BMMC22_CD4_pos_T_naive	BMMC22_pDC	27541	65164	61970	37623	34429	0.02274479	0.3239981	0.2129953
BMMC22_CD4_pos_T_naive	BMMC22_Plasma_cell	27987	65164	65478	37177	37491	-0.006118251	0.292663	0.1836414
BMMC22_CD4_pos_T_naive	BMMC22_Proerythroblast	24093	65164	63281	41071	39188	-0.08912201	0.2357192	0.1199596
BMMC22_CD4_pos_T_naive	BMMC22_Transitional_B	26041	65164	63246	39123	37205	-0.03097059	0.2878556	0.1737413
BMMC22_CD4_pos_T_naive	PBMC5_B	30139	65164	61777	35025	31638	0.08564515	0.36788	0.2600135
BMMC22_CD4_pos_T_naive	PBMC5_DC	22358	65164	54841	42806	32483	-0.08395633	0.231378	0.1195012
BMMC22_CD4_pos_T_naive	PBMC5_Mono	24472	65164	63455	40692	38983	-0.07657553	0.2446806	0.1305673
BMMC22_CD4_pos_T_naive	PBMC5_NK	30770	65164	58922	34394	28152	0.1118245	0.372582	0.2708862
BMMC22_CD4_pos_T_naive	PBMC5_T	41490	65164	59027	23674	17537	0.422788	0.579527	0.4956106
BMMC22_CD4_pos_T_naive	PBMC_10_cDC	23550	65164	55848	41614	32298	-0.05362396	0.2568104	0.1456144
BMMC22_CD4_pos_T_naive	PBMC_11_CD14.Mono.1	19804	65164	59470	45360	39666	-0.185366	0.1639903	0.04626153
BMMC22_CD4_pos_T_naive	PBMC_12_CD14.Mono.2	20935	65164	59397	44229	38462	-0.1499254	0.1922172	0.07474701
BMMC22_CD4_pos_T_naive	PBMC_13_CD16.Mono	21466	65164	54592	43698	33126	-0.1047237	0.2190008	0.105674
BMMC22_CD4_pos_T_naive	PBMC_17_B	26427	65164	58277	38737	31850	0.01381799	0.3208412	0.209434
BMMC22_CD4_pos_T_naive	PBMC_20_CD4.N1	34827	65164	60378	30337	25551	0.2126873	0.4466156	0.3489601
BMMC22_CD4_pos_T_naive	PBMC_22_CD4.M	41655	65164	59146	23509	17491	0.4377749	0.5986347	0.5135032
BMMC22_CD4_pos_T_naive	PBMC_24_CD8.CM	36211	65164	59210	28953	22999	0.2646622	0.4792426	0.3851346
BMMC22_CD4_pos_T_naive	PBMC_25_NK	30335	65164	57699	34829	27364	0.1087852	0.3690704	0.2675406
BMMC22_CD4_pos_T_naive	Islets_beta	18120	65164	63734	47044	45614	-0.2693	0.07331607	-0.04132528
BMMC22_CD4_pos_T_naive	Islets_alpha	17968	65164	65486	47196	47518	-0.2696429	0.08680571	-0.02984812
BMMC22_CD4_pos_T_naive	Islets_delta	18591	65164	61673	46573	43082	-0.2374115	0.1113409	-0.004586804
BMMC22_CD4_pos_T_naive	Islets_PP	17939	65164	63824	47225	45885	-0.2611302	0.1019972	-0.01608725
BMMC22_CD4_pos_T_naive	Islets_acinar	18869	65164	66719	46295	47850	-0.2533106	0.09775253	-0.01955952
BMMC22_CD4_pos_T_naive	Islets_duct	18492	65164	63744	46672	45252	-0.2455895	0.1118477	-0.006087798
BMMC22_CD4_pos_T_naive	Islets_endothelial	19037	65164	64155	46127	45118	-0.2403546	0.1109042	-0.005293184
BMMC22_CD4_pos_T_naive	Islets_immune	22106	65164	67939	43058	45833	-0.1853976	0.148076	0.03495401
BMMC22_CD4_pos_T_naive	Islets_mesenchymal	18370	65164	62786	46794	44416	-0.2492082	0.1009855	-0.01454339
BMMC22_CD4_pos_T_naive	HCT116	19144	65164	64892	46020	45748	-0.2378088	0.1104411	-0.006187493
BMMC22_CD4_pos_T_naive	WTC11_from_HPC_diff	17322	65164	58398	47842	41076	-0.2586147	0.09600164	-0.01959617
BMMC22_CD4_pos_T_naive	Jurkat	24229	65164	58783	40935	34554	-0.09439566	0.2080126	0.100953
BMMC22_CD8_pos_T	BMMC22_CD8_pos_T	56554	56554	56554	0	0	1	1	1
BMMC22_CD8_pos_T	BMMC22_CD8_pos_T_naive	31101	56554	63902	25453	32801	0.1683425	0.4222167	0.3204878
BMMC22_CD8_pos_T	BMMC22_CD14_pos_Mono	22484	56554	64846	34070	42362	-0.09931596	0.220707	0.1077717
BMMC22_CD8_pos_T	BMMC22_CD16_pos_Mono	22935	56554	61683	33619	38748	-0.06099443	0.2617246	0.1479244
BMMC22_CD8_pos_T	BMMC22_cDC2	24759	56554	60955	31795	36196	0.002540473	0.3081997	0.1971148
BMMC22_CD8_pos_T	BMMC22_Erythroblast	21617	56554	62295	34937	40678	-0.1027027	0.2182543	0.1039161
BMMC22_CD8_pos_T	BMMC22_G_M_prog	25256	56554	63921	31298	38665	-0.00851282	0.2935524	0.183975
BMMC22_CD8_pos_T	BMMC22_HSC	26066	56554	64808	30488	38742	0.009944585	0.3076609	0.1991832
BMMC22_CD8_pos_T	BMMC22_ID2_hi_myeloid_prog	11677	56554	35748	44877	24071	-0.3029017	-7.676637e-05	-0.1026847
BMMC22_CD8_pos_T	BMMC22_ILC	30662	56554	56304	25892	25642	0.1881245	0.4238897	0.3263127
BMMC22_CD8_pos_T	BMMC22_Lymph_prog	27335	56554	66487	29219	39152	0.03755964	0.3287985	0.2208049
BMMC22_CD8_pos_T	BMMC22_MK_E_prog	24497	56554	63497	32057	39000	-0.02739239	0.2809038	0.170103
BMMC22_CD8_pos_T	BMMC22_Naive_CD20_pos_B	27865	56554	63355	28689	35490	0.08183781	0.3738641	0.2641036
BMMC22_CD8_pos_T	BMMC22_NK	39330	56554	66621	17224	27291	0.3956019	0.5738262	0.4858875
BMMC22_CD8_pos_T	BMMC22_Normoblast	18932	56554	56020	37622	37088	-0.1579703	0.179575	0.0665181
BMMC22_CD8_pos_T	BMMC22_pDC	25750	56554	61970	30804	36220	0.01713124	0.314524	0.2053136
BMMC22_CD8_pos_T	BMMC22_Plasma_cell	26992	56554	65478	29562	38486	0.02542524	0.3136571	0.2068407
BMMC22_CD8_pos_T	BMMC22_Proerythroblast	22932	56554	63281	33622	40349	-0.07066891	0.2488641	0.135062
BMMC22_CD8_pos_T	BMMC22_Transitional_B	24977	56554	63246	31577	38269	-0.004839495	0.3085077	0.1957659
BMMC22_CD8_pos_T	PBMC5_B	28838	56554	61777	27716	32939	0.1094974	0.3846643	0.2783732
BMMC22_CD8_pos_T	PBMC5_DC	22073	56554	54841	34481	32768	-0.05250566	0.2578148	0.1468981
BMMC22_CD8_pos_T	PBMC5_Mono	24109	56554	63455	32445	39346	-0.03887928	0.2721587	0.1599861
BMMC22_CD8_pos_T	PBMC5_NK	33150	56554	58922	23404	25772	0.2333605	0.4491123	0.3549412
BMMC22_CD8_pos_T	PBMC5_T	36715	56554	59027	19839	22312	0.3569307	0.539303	0.4497544
BMMC22_CD8_pos_T	PBMC_10_cDC	23225	56554	55848	33329	32623	-0.0215091	0.2833226	0.1730643
BMMC22_CD8_pos_T	PBMC_11_CD14.Mono.1	19506	56554	59470	37048	39964	-0.1545815	0.1877422	0.07203142
BMMC22_CD8_pos_T	PBMC_12_CD14.Mono.2	20724	56554	59397	35830	38673	-0.1168307	0.2176379	0.1021239
BMMC22_CD8_pos_T	PBMC_13_CD16.Mono	21381	56554	54592	35173	33211	-0.06851592	0.2509813	0.1383604
BMMC22_CD8_pos_T	PBMC_17_B	25462	56554	58277	31092	32815	0.03678158	0.3384118	0.2282239
BMMC22_CD8_pos_T	PBMC_20_CD4.N1	30187	56554	60378	26367	30191	0.1522794	0.4085959	0.3074199
BMMC22_CD8_pos_T	PBMC_22_CD4.M	35456	56554	59146	21098	23690	0.3239164	0.5246282	0.4310902
BMMC22_CD8_pos_T	PBMC_24_CD8.CM	38237	56554	59210	18317	20973	0.3907984	0.5585328	0.4722099
BMMC22_CD8_pos_T	PBMC_25_NK	32739	56554	57699	23815	24960	0.2294034	0.4455088	0.3513491
BMMC22_CD8_pos_T	Islets_beta	16904	56554	63734	39650	46830	-0.2614296	0.08272394	-0.03124139
BMMC22_CD8_pos_T	Islets_alpha	16787	56554	65486	39767	48699	-0.2618064	0.0939694	-0.02156248
BMMC22_CD8_pos_T	Islets_delta	17272	56554	61673	39282	44401	-0.2345817	0.1172803	0.001663035
BMMC22_CD8_pos_T	Islets_PP	16657	56554	63824	39897	47167	-0.2571013	0.1062672	-0.01079476
BMMC22_CD8_pos_T	Islets_acinar	17620	56554	66719	38934	49099	-0.2441258	0.1057005	-0.01037079
BMMC22_CD8_pos_T	Islets_duct	17258	56554	63744	39296	46486	-0.2403116	0.1173175	0.0004788376
BMMC22_CD8_pos_T	Islets_endothelial	17969	56554	64155	38585	46186	-0.2239185	0.1282396	0.01253193
BMMC22_CD8_pos_T	Islets_immune	21032	56554	67939	35522	46907	-0.1625595	0.1672128	0.05520099
BMMC22_CD8_pos_T	Islets_mesenchymal	17273	56554	62786	39281	45513	-0.2413485	0.1102731	-0.00463986
BMMC22_CD8_pos_T	HCT116	17961	56554	64892	38593	46931	-0.220889	0.1265601	0.01078935
BMMC22_CD8_pos_T	WTC11_from_HPC_diff	15832	56554	58398	40722	42566	-0.2644081	0.09457809	-0.02080869
BMMC22_CD8_pos_T	Jurkat	22167	56554	58783	34387	36616	-0.09154611	0.219638	0.1111489
BMMC22_CD8_pos_T_naive	BMMC22_CD8_pos_T_naive	63902	63902	63902	0	0	1	1	1
BMMC22_CD8_pos_T_naive	BMMC22_CD14_pos_Mono	21447	63902	64846	42455	43399	-0.1630758	0.181511	0.06417204
BMMC22_CD8_pos_T_naive	BMMC22_CD16_pos_Mono	21952	63902	61683	41950	39731	-0.1298935	0.2135762	0.09615826
BMMC22_CD8_pos_T_naive	BMMC22_cDC2	23729	63902	60955	40173	37226	-0.07440258	0.252422	0.1380014
BMMC22_CD8_pos_T_naive	BMMC22_Erythroblast	21837	63902	62295	42065	40458	-0.147398	0.1851472	0.06976079
BMMC22_CD8_pos_T_naive	BMMC22_G_M_prog	25137	63902	63921	38765	38784	-0.06128013	0.2582493	0.1454921
BMMC22_CD8_pos_T_naive	BMMC22_HSC	26940	63902	64808	36962	37868	-0.02072649	0.2893081	0.1782868
BMMC22_CD8_pos_T_naive	BMMC22_ID2_hi_myeloid_prog	10763	63902	35748	53139	24985	-0.3442391	-0.03996166	-0.143035
BMMC22_CD8_pos_T_naive	BMMC22_ILC	26513	63902	56304	37389	29791	0.01835994	0.3129959	0.2056989
BMMC22_CD8_pos_T_naive	BMMC22_Lymph_prog	27871	63902	66487	36031	38616	-0.009383087	0.2958807	0.1855592
BMMC22_CD8_pos_T_naive	BMMC22_MK_E_prog	25219	63902	63497	38683	38278	-0.0584189	0.2615659	0.1484226
BMMC22_CD8_pos_T_naive	BMMC22_Naive_CD20_pos_B	27434	63902	63355	36468	35921	0.0135132	0.3275936	0.2141941
BMMC22_CD8_pos_T_naive	BMMC22_NK	30938	63902	66621	32964	35683	0.08439156	0.3716631	0.2637414
BMMC22_CD8_pos_T_naive	BMMC22_Normoblast	19101	63902	56020	44801	36919	-0.1981747	0.1447209	0.03090999
BMMC22_CD8_pos_T_naive	BMMC22_pDC	26169	63902	61970	37733	35801	-0.008548393	0.307862	0.1946271
BMMC22_CD8_pos_T_naive	BMMC22_Plasma_cell	26775	63902	65478	37127	38703	-0.03207147	0.2781885	0.1672792
BMMC22_CD8_pos_T_naive	BMMC22_Proerythroblast	22878	63902	63281	41024	40403	-0.1145373	0.2218294	0.1051415
BMMC22_CD8_pos_T_naive	BMMC22_Transitional_B	24904	63902	63246	38998	38342	-0.05652663	0.2720457	0.1570008
BMMC22_CD8_pos_T_naive	PBMC5_B	27827	63902	61777	36075	33950	0.02376473	0.325748	0.2150951
BMMC22_CD8_pos_T_naive	PBMC5_DC	21174	63902	54841	42728	33667	-0.1178167	0.2092772	0.09585812
BMMC22_CD8_pos_T_naive	PBMC5_Mono	22459	63902	63455	41443	40996	-0.1253	0.2121357	0.096143
BMMC22_CD8_pos_T_naive	PBMC5_NK	28081	63902	58922	35821	30841	0.03921282	0.3241906	0.2187594
BMMC22_CD8_pos_T_naive	PBMC5_T	33892	63902	59027	30010	25135	0.2042326	0.4317908	0.3358572
BMMC22_CD8_pos_T_naive	PBMC_10_cDC	22285	63902	55848	41617	33563	-0.0871152	0.2365548	0.1235743
BMMC22_CD8_pos_T_naive	PBMC_11_CD14.Mono.1	18869	63902	59470	45033	40601	-0.2075494	0.15066	0.03187431
BMMC22_CD8_pos_T_naive	PBMC_12_CD14.Mono.2	19480	63902	59397	44422	39917	-0.1837587	0.1726762	0.05335201
BMMC22_CD8_pos_T_naive	PBMC_13_CD16.Mono	20161	63902	54592	43741	34431	-0.1404009	0.1966134	0.08142708
BMMC22_CD8_pos_T_naive	PBMC_17_B	24841	63902	58277	39061	33436	-0.02754713	0.2944145	0.1809809
BMMC22_CD8_pos_T_naive	PBMC_20_CD4.N1	32621	63902	60378	31281	27757	0.1509917	0.4042361	0.3036492
BMMC22_CD8_pos_T_naive	PBMC_22_CD4.M	34456	63902	59146	29446	24690	0.2290342	0.4582016	0.3611457
BMMC22_CD8_pos_T_naive	PBMC_24_CD8.CM	31323	63902	59210	32579	27887	0.1266226	0.3856663	0.2840906
BMMC22_CD8_pos_T_naive	PBMC_25_NK	27644	63902	57699	36258	30055	0.03528052	0.3200497	0.2147497
BMMC22_CD8_pos_T_naive	Islets_beta	16801	63902	63734	47101	46933	-0.294311	0.0602423	-0.05540394
BMMC22_CD8_pos_T_naive	Islets_alpha	16712	63902	65486	47190	48774	-0.2940356	0.0739082	-0.04381764
BMMC22_CD8_pos_T_naive	Islets_delta	17469	63902	61673	46433	44204	-0.2609024	0.09948998	-0.01730267
BMMC22_CD8_pos_T_naive	Islets_PP	17227	63902	63824	46675	46597	-0.2728407	0.09974342	-0.01933056
BMMC22_CD8_pos_T_naive	Islets_acinar	17596	63902	66719	46306	49123	-0.2808644	0.08083849	-0.03714353
BMMC22_CD8_pos_T_naive	Islets_duct	17800	63902	63744	46102	45944	-0.2586127	0.1082273	-0.01067003
BMMC22_CD8_pos_T_naive	Islets_endothelial	18698	63902	64155	45204	45457	-0.2450386	0.1115777	-0.005043747
BMMC22_CD8_pos_T_naive	Islets_immune	21213	63902	67939	42689	46726	-0.2034517	0.1386544	0.02432589
BMMC22_CD8_pos_T_naive	Islets_mesenchymal	17619	63902	62786	46283	45167	-0.2642126	0.094877	-0.0215615
BMMC22_CD8_pos_T_naive	HCT116	18421	63902	64892	45481	46471	-0.2493009	0.107045	-0.01054655
BMMC22_CD8_pos_T_naive	WTC11_from_HPC_diff	17040	63902	58398	46862	41358	-0.25832	0.1038682	-0.01267784
BMMC22_CD8_pos_T_naive	Jurkat	23173	63902	58783	40729	35610	-0.1162844	0.1951593	0.0871081
BMMC22_CD14_pos_Mono	BMMC22_CD14_pos_Mono	64846	64846	64846	0	0	1	1	1
BMMC22_CD14_pos_Mono	BMMC22_CD16_pos_Mono	40088	64846	61683	24758	21595	0.3299792	0.514764	0.4248653
BMMC22_CD14_pos_Mono	BMMC22_cDC2	36300	64846	60955	28546	24655	0.2289551	0.441568	0.3465567
BMMC22_CD14_pos_Mono	BMMC22_Erythroblast	20855	64846	62295	43991	41440	-0.1796834	0.1556755	0.03847661
BMMC22_CD14_pos_Mono	BMMC22_G_M_prog	36577	64846	63921	28269	27344	0.2022858	0.4196252	0.3243451
BMMC22_CD14_pos_Mono	BMMC22_HSC	28817	64846	64808	36029	35991	0.0123253	0.301606	0.1934178
BMMC22_CD14_pos_Mono	BMMC22_ID2_hi_myeloid_prog	15830	64846	35748	49016	19918	-0.2198844	0.008726431	-0.07922236
BMMC22_CD14_pos_Mono	BMMC22_ILC	19364	64846	56304	45482	36940	-0.1931737	0.1480636	0.03332447
BMMC22_CD14_pos_Mono	BMMC22_Lymph_prog	26660	64846	66487	38186	39827	-0.05509397	0.2513653	0.140303
BMMC22_CD14_pos_Mono	BMMC22_MK_E_prog	25204	64846	63497	39642	38293	-0.06727326	0.2497327	0.1361136
BMMC22_CD14_pos_Mono	BMMC22_Naive_CD20_pos_B	28303	64846	63355	36543	35052	0.008507125	0.3040959	0.1949002
BMMC22_CD14_pos_Mono	BMMC22_NK	24689	64846	66621	40157	41932	-0.09207536	0.2363352	0.1205593
BMMC22_CD14_pos_Mono	BMMC22_Normoblast	16336	64846	56020	48510	39684	-0.2825787	0.07052768	-0.04452857
BMMC22_CD14_pos_Mono	BMMC22_pDC	28408	64846	61970	36438	33562	0.02290836	0.3110998	0.2028529
BMMC22_CD14_pos_Mono	BMMC22_Plasma_cell	22400	64846	65478	42446	43078	-0.1530082	0.1827848	0.06744779
BMMC22_CD14_pos_Mono	BMMC22_Proerythroblast	22478	64846	63281	42368	40803	-0.1338547	0.2018628	0.08345517
BMMC22_CD14_pos_Mono	BMMC22_Transitional_B	24794	64846	63246	40052	38452	-0.07889329	0.2421818	0.1284585
BMMC22_CD14_pos_Mono	PBMC5_B	26304	64846	61777	38542	35473	-0.03813397	0.2637684	0.1543534
BMMC22_CD14_pos_Mono	PBMC5_DC	32325	64846	54841	32521	22516	0.1569008	0.3800159	0.2850493
BMMC22_CD14_pos_Mono	PBMC5_Mono	42911	64846	63455	21935	20544	0.3621204	0.519895	0.4342758
BMMC22_CD14_pos_Mono	PBMC5_NK	20566	64846	58922	44280	38356	-0.1746433	0.1621173	0.04812844
BMMC22_CD14_pos_Mono	PBMC5_T	22046	64846	59027	42800	36981	-0.138984	0.1810229	0.06916685
BMMC22_CD14_pos_Mono	PBMC_10_cDC	33142	64846	55848	31704	22706	0.1669096	0.3844687	0.2903416
BMMC22_CD14_pos_Mono	PBMC_11_CD14.Mono.1	36866	64846	59470	27980	22604	0.2286407	0.4306362	0.3394257
BMMC22_CD14_pos_Mono	PBMC_12_CD14.Mono.2	41383	64846	59397	23463	18014	0.3707839	0.5330243	0.4474861
BMMC22_CD14_pos_Mono	PBMC_13_CD16.Mono	33187	64846	54592	31659	21405	0.1783404	0.3916902	0.2986526
BMMC22_CD14_pos_Mono	PBMC_17_B	22815	64846	58277	42031	35462	-0.1056138	0.2192819	0.1066453
BMMC22_CD14_pos_Mono	PBMC_20_CD4.N1	19331	64846	60378	45515	41047	-0.2152415	0.133067	0.01782117
BMMC22_CD14_pos_Mono	PBMC_22_CD4.M	21949	64846	59146	42897	37197	-0.1378842	0.1882023	0.07476582
BMMC22_CD14_pos_Mono	PBMC_24_CD8.CM	20854	64846	59210	43992	38356	-0.1678426	0.169288	0.05500655
BMMC22_CD14_pos_Mono	PBMC_25_NK	20302	64846	57699	44544	37397	-0.1733808	0.1638768	0.04962635
BMMC22_CD14_pos_Mono	Islets_beta	17131	64846	63734	47715	46603	-0.2914976	0.05642573	-0.05937187
BMMC22_CD14_pos_Mono	Islets_alpha	17263	64846	65486	47583	48223	-0.2871149	0.07318116	-0.04442678
BMMC22_CD14_pos_Mono	Islets_delta	17473	64846	61673	47373	44200	-0.2653213	0.0909119	-0.02637335
BMMC22_CD14_pos_Mono	Islets_PP	16781	64846	63824	48065	47043	-0.2892258	0.08099373	-0.03842573
BMMC22_CD14_pos_Mono	Islets_acinar	18873	64846	66719	45973	47846	-0.2511674	0.1016452	-0.01648911
BMMC22_CD14_pos_Mono	Islets_duct	18585	64846	63744	46261	45159	-0.240828	0.1178058	-0.0007193302
BMMC22_CD14_pos_Mono	Islets_endothelial	18488	64846	64155	46358	45667	-0.2560274	0.09544886	-0.02039426
BMMC22_CD14_pos_Mono	Islets_immune	27241	64846	67939	37605	40698	-0.08061942	0.2087489	0.1040324
BMMC22_CD14_pos_Mono	Islets_mesenchymal	19566	64846	62786	45280	43220	-0.2236669	0.118872	0.004248009
BMMC22_CD14_pos_Mono	HCT116	17736	64846	64892	47110	47156	-0.2819948	0.06750554	-0.04877128
BMMC22_CD14_pos_Mono	WTC11_from_HPC_diff	16309	64846	58398	48537	42089	-0.2814351	0.08344011	-0.0348644
BMMC22_CD14_pos_Mono	Jurkat	17487	64846	58783	47359	41296	-0.2924789	0.04174719	-0.06948646
BMMC22_CD16_pos_Mono	BMMC22_CD16_pos_Mono	61683	61683	61683	0	0	1	1	1
BMMC22_CD16_pos_Mono	BMMC22_cDC2	36260	61683	60955	25423	24695	0.2464191	0.453541	0.3598334
BMMC22_CD16_pos_Mono	BMMC22_Erythroblast	20078	61683	62295	41605	42217	-0.1741792	0.1698397	0.05132264
BMMC22_CD16_pos_Mono	BMMC22_G_M_prog	34011	61683	63921	27672	29910	0.1517899	0.3872236	0.2890189
BMMC22_CD16_pos_Mono	BMMC22_HSC	27660	61683	64808	34023	37148	-0.006290146	0.287395	0.1792513
BMMC22_CD16_pos_Mono	BMMC22_ID2_hi_myeloid_prog	17924	61683	35748	43759	17824	-0.1238384	0.1037322	0.0152067
BMMC22_CD16_pos_Mono	BMMC22_ILC	21234	61683	56304	40449	35070	-0.1138065	0.225641	0.1095744
BMMC22_CD16_pos_Mono	BMMC22_Lymph_prog	26439	61683	66487	35244	40048	-0.04394039	0.2615345	0.1509522
BMMC22_CD16_pos_Mono	BMMC22_MK_E_prog	24785	61683	63497	36898	38712	-0.06168838	0.2573837	0.1435953
BMMC22_CD16_pos_Mono	BMMC22_Naive_CD20_pos_B	28922	61683	63355	32761	34433	0.04785214	0.3367982	0.2286671
BMMC22_CD16_pos_Mono	BMMC22_NK	24584	61683	66621	37099	42037	-0.06648919	0.2651914	0.1487117
BMMC22_CD16_pos_Mono	BMMC22_Normoblast	17752	61683	56020	43931	38268	-0.216459	0.1395782	0.02246374
BMMC22_CD16_pos_Mono	BMMC22_pDC	27712	61683	61970	33971	34258	0.01194719	0.3009894	0.1930923
BMMC22_CD16_pos_Mono	BMMC22_Plasma_cell	24201	61683	65478	37482	41277	-0.0844753	0.2423044	0.1274786
BMMC22_CD16_pos_Mono	BMMC22_Proerythroblast	21506	61683	63281	40177	41775	-0.1418481	0.2000292	0.08120128
BMMC22_CD16_pos_Mono	BMMC22_Transitional_B	25216	61683	63246	36467	38030	-0.04904799	0.2689694	0.1557145
BMMC22_CD16_pos_Mono	PBMC5_B	28212	61683	61777	33471	33565	0.0353198	0.3235489	0.2157016
BMMC22_CD16_pos_Mono	PBMC5_DC	33694	61683	54841	27989	21147	0.2232083	0.4325137	0.3391849
BMMC22_CD16_pos_Mono	PBMC5_Mono	39927	61683	63455	21756	23528	0.3171224	0.495576	0.4071068
BMMC22_CD16_pos_Mono	PBMC5_NK	22193	61683	58922	39490	36729	-0.105403	0.2290218	0.114055
BMMC22_CD16_pos_Mono	PBMC5_T	21955	61683	59027	39728	37072	-0.1170088	0.2080813	0.09521697
BMMC22_CD16_pos_Mono	PBMC_10_cDC	34479	61683	55848	27204	21369	0.2338265	0.438542	0.345854
BMMC22_CD16_pos_Mono	PBMC_11_CD14.Mono.1	35119	61683	59470	26564	24351	0.2240469	0.4408855	0.3462116
BMMC22_CD16_pos_Mono	PBMC_12_CD14.Mono.2	37969	61683	59397	23714	21428	0.3095297	0.4994338	0.4089614
BMMC22_CD16_pos_Mono	PBMC_13_CD16.Mono	38686	61683	54592	22997	15906	0.3534398	0.5100464	0.4256852
BMMC22_CD16_pos_Mono	PBMC_17_B	24731	61683	58277	36952	33546	-0.03150255	0.2823213	0.1707596
BMMC22_CD16_pos_Mono	PBMC_20_CD4.N1	21072	61683	60378	40611	39306	-0.1423206	0.2039743	0.08764668
BMMC22_CD16_pos_Mono	PBMC_22_CD4.M	21833	61683	59146	39850	37313	-0.1148669	0.217063	0.1024842
BMMC22_CD16_pos_Mono	PBMC_24_CD8.CM	22021	61683	59210	39662	37189	-0.1104255	0.2269812	0.1114994
BMMC22_CD16_pos_Mono	PBMC_25_NK	21916	61683	57699	39767	35783	-0.1054201	0.2291599	0.1141029
BMMC22_CD16_pos_Mono	Islets_beta	15833	61683	63734	45850	47901	-0.3088813	0.04965021	-0.06747886
BMMC22_CD16_pos_Mono	Islets_alpha	15883	61683	65486	45800	49603	-0.3079422	0.06187954	-0.05670726
BMMC22_CD16_pos_Mono	Islets_delta	16365	61683	61673	45318	45308	-0.2800104	0.08551114	-0.03287807
BMMC22_CD16_pos_Mono	Islets_PP	16145	61683	63824	45538	47679	-0.2916505	0.08531681	-0.03511573
BMMC22_CD16_pos_Mono	Islets_acinar	17430	61683	66719	44253	49289	-0.2731447	0.0881019	-0.03083697
BMMC22_CD16_pos_Mono	Islets_duct	17622	61683	63744	44061	46122	-0.2524938	0.1133296	-0.006119301
BMMC22_CD16_pos_Mono	Islets_endothelial	18267	61683	64155	43416	45888	-0.2408809	0.1194333	0.001349722
BMMC22_CD16_pos_Mono	Islets_immune	27404	61683	67939	34279	40535	-0.05317201	0.2375156	0.1317657
BMMC22_CD16_pos_Mono	Islets_mesenchymal	18291	61683	62786	43392	44495	-0.2394379	0.1147239	-0.001780689
BMMC22_CD16_pos_Mono	HCT116	17353	61683	64892	44330	47539	-0.2629406	0.09814365	-0.02105171
BMMC22_CD16_pos_Mono	WTC11_from_HPC_diff	15392	61683	58398	46291	43006	-0.2957202	0.07546157	-0.04332247
BMMC22_CD16_pos_Mono	Jurkat	17615	61683	58783	44068	41168	-0.2504301	0.09823559	-0.01711908
BMMC22_cDC2	BMMC22_cDC2	60955	60955	60955	0	0	1	1	1
BMMC22_cDC2	BMMC22_Erythroblast	20651	60955	62295	40304	41644	-0.1502647	0.1861653	0.06910282
BMMC22_cDC2	BMMC22_G_M_prog	39138	60955	63921	21817	24783	0.3001833	0.4853593	0.3951097
BMMC22_cDC2	BMMC22_HSC	31921	60955	64808	29034	32887	0.1193286	0.3767265	0.2741225
BMMC22_cDC2	BMMC22_ID2_hi_myeloid_prog	17205	60955	35748	43750	18543	-0.1517855	0.08713125	-0.00288361
BMMC22_cDC2	BMMC22_ILC	23076	60955	56304	37879	33228	-0.05879636	0.2618783	0.1492291
BMMC22_cDC2	BMMC22_Lymph_prog	30959	60955	66487	29996	35528	0.08947431	0.3587081	0.2532659
BMMC22_cDC2	BMMC22_MK_E_prog	27784	60955	63497	33171	35713	0.0261078	0.319343	0.2093241
BMMC22_cDC2	BMMC22_Naive_CD20_pos_B	31152	60955	63355	29803	32203	0.1197841	0.3867567	0.2823737
BMMC22_cDC2	BMMC22_NK	26184	60955	66621	34771	40437	-0.01015068	0.3059316	0.1923516
BMMC22_cDC2	BMMC22_Normoblast	18254	60955	56020	42701	37766	-0.2026839	0.1447722	0.0294523
BMMC22_cDC2	BMMC22_pDC	33362	60955	61970	27593	28608	0.1641835	0.399721	0.3006978
BMMC22_cDC2	BMMC22_Plasma_cell	26774	60955	65478	34181	38704	-0.01525317	0.2860131	0.17587
BMMC22_cDC2	BMMC22_Proerythroblast	23334	60955	63281	37621	39947	-0.08273504	0.2447615	0.1278826
BMMC22_cDC2	BMMC22_Transitional_B	28670	60955	63246	32285	34576	0.05400785	0.3426303	0.234036
BMMC22_cDC2	PBMC5_B	30765	60955	61777	30190	31012	0.1145012	0.3772484	0.2737757
BMMC22_cDC2	PBMC5_DC	38054	60955	54841	22901	16787	0.3314783	0.4916821	0.4068394
BMMC22_cDC2	PBMC5_Mono	37033	60955	63455	23922	26422	0.2558018	0.4566232	0.3636047
BMMC22_cDC2	PBMC5_NK	24008	60955	58922	36947	34914	-0.04770431	0.2692498	0.15736
BMMC22_cDC2	PBMC5_T	23844	60955	59027	37111	35183	-0.05371475	0.2559941	0.1454198
BMMC22_cDC2	PBMC_10_cDC	38663	60955	55848	22292	17185	0.3466792	0.5053983	0.4205314
BMMC22_cDC2	PBMC_11_CD14.Mono.1	32525	60955	59470	28430	26945	0.1518558	0.3861781	0.2892007
BMMC22_cDC2	PBMC_12_CD14.Mono.2	34680	60955	59397	26275	24717	0.2283702	0.4458604	0.3506518
BMMC22_cDC2	PBMC_13_CD16.Mono	33607	60955	54592	27348	20985	0.2261682	0.4330601	0.3401816
BMMC22_cDC2	PBMC_17_B	26844	60955	58277	34111	31433	0.03558819	0.3294297	0.2214488
BMMC22_cDC2	PBMC_20_CD4.N1	22632	60955	60378	38323	37746	-0.0910604	0.2415664	0.1277619
BMMC22_cDC2	PBMC_22_CD4.M	23762	60955	59146	37193	35384	-0.0499263	0.2661553	0.1539406
BMMC22_cDC2	PBMC_24_CD8.CM	23997	60955	59210	36958	35213	-0.04448761	0.2757221	0.1632329
BMMC22_cDC2	PBMC_25_NK	23678	60955	57699	37277	34021	-0.04933385	0.2682741	0.1563693
BMMC22_cDC2	Islets_beta	16578	60955	63734	44377	47156	-0.2841671	0.06780487	-0.04825488
BMMC22_cDC2	Islets_alpha	16713	60955	65486	44242	48773	-0.2784435	0.08598887	-0.03193374
BMMC22_cDC2	Islets_delta	17257	60955	61673	43698	44416	-0.2481317	0.111455	-0.006275097
BMMC22_cDC2	Islets_PP	17115	60955	63824	43840	46709	-0.2594286	0.110321	-0.009042174
BMMC22_cDC2	Islets_acinar	18369	60955	66719	42586	48350	-0.244046	0.1088399	-0.008830814
BMMC22_cDC2	Islets_duct	18769	60955	63744	42186	44975	-0.2190661	0.1362437	0.01855081
BMMC22_cDC2	Islets_endothelial	19700	60955	64155	41255	44455	-0.2000789	0.1472639	0.03116039
BMMC22_cDC2	Islets_immune	28889	60955	67939	32066	39050	-0.01071311	0.2628995	0.1599428
BMMC22_cDC2	Islets_mesenchymal	19333	60955	62786	41622	43453	-0.2061874	0.1401033	0.02464819
BMMC22_cDC2	HCT116	18476	60955	64892	42479	46416	-0.2241769	0.1287906	0.01063328
BMMC22_cDC2	WTC11_from_HPC_diff	16495	60955	58398	44460	41903	-0.2592555	0.1048807	-0.01295317
BMMC22_cDC2	Jurkat	19607	60955	58783	41348	39176	-0.19266	0.1409795	0.02805935
BMMC22_Erythroblast	BMMC22_Erythroblast	62295	62295	62295	0	0	1	1	1
BMMC22_Erythroblast	BMMC22_G_M_prog	22271	62295	63921	40024	41650	-0.1353455	0.1896634	0.07497203
BMMC22_Erythroblast	BMMC22_HSC	23472	62295	64808	38823	41336	-0.1154831	0.201912	0.08925625
BMMC22_Erythroblast	BMMC22_ID2_hi_myeloid_prog	10797	62295	35748	51498	24951	-0.3322262	-0.03219104	-0.1363174
BMMC22_Erythroblast	BMMC22_ILC	19910	62295	56304	42385	36394	-0.1526497	0.1842149	0.06823474
BMMC22_Erythroblast	BMMC22_Lymph_prog	22869	62295	66487	39426	43618	-0.1307237	0.1966044	0.08111873
BMMC22_Erythroblast	BMMC22_MK_E_prog	29501	62295	63497	32794	33996	0.04815801	0.317628	0.2141312
BMMC22_Erythroblast	BMMC22_Naive_CD20_pos_B	21884	62295	63355	40411	41471	-0.1391424	0.1969375	0.07961236
BMMC22_Erythroblast	BMMC22_NK	23334	62295	66621	38961	43287	-0.1114801	0.219057	0.1021448
BMMC22_Erythroblast	BMMC22_Normoblast	27674	62295	56020	34621	28346	0.05864097	0.3299217	0.2270964
BMMC22_Erythroblast	BMMC22_pDC	21158	62295	61970	41137	40812	-0.1562081	0.1740775	0.05879827
BMMC22_Erythroblast	BMMC22_Plasma_cell	21080	62295	65478	41215	44398	-0.1687325	0.1697755	0.05286847
BMMC22_Erythroblast	BMMC22_Proerythroblast	36913	62295	63281	25382	26368	0.2568311	0.4642477	0.3700355
BMMC22_Erythroblast	BMMC22_Transitional_B	21025	62295	63246	41270	42221	-0.1599434	0.1818956	0.06378763
BMMC22_Erythroblast	PBMC5_B	21271	62295	61777	41024	40506	-0.1447723	0.1924146	0.07501765
BMMC22_Erythroblast	PBMC5_DC	18875	62295	54841	43420	35966	-0.1715251	0.1649687	0.04834716
BMMC22_Erythroblast	PBMC5_Mono	20052	62295	63455	42243	43403	-0.1862403	0.1546544	0.03653314
BMMC22_Erythroblast	PBMC5_NK	20799	62295	58922	41496	38123	-0.1401202	0.196714	0.08030515
BMMC22_Erythroblast	PBMC5_T	21707	62295	59027	40588	37320	-0.1288372	0.188233	0.07589665
BMMC22_Erythroblast	PBMC_10_cDC	19376	62295	55848	42919	36472	-0.1611584	0.1742527	0.05774087
BMMC22_Erythroblast	PBMC_11_CD14.Mono.1	17680	62295	59470	44615	41790	-0.2309225	0.1248506	0.005141163
BMMC22_Erythroblast	PBMC_12_CD14.Mono.2	18522	62295	59397	43773	40875	-0.2035076	0.1471495	0.02747726
BMMC22_Erythroblast	PBMC_13_CD16.Mono	18119	62295	54592	44176	36473	-0.1878905	0.1547291	0.03702954
BMMC22_Erythroblast	PBMC_17_B	19752	62295	58277	42543	38525	-0.1651203	0.1797956	0.06184706
BMMC22_Erythroblast	PBMC_20_CD4.N1	20375	62295	60378	41920	40003	-0.1678857	0.1726506	0.056758
BMMC22_Erythroblast	PBMC_22_CD4.M	21803	62295	59146	40492	37343	-0.1232589	0.1980442	0.08447753
BMMC22_Erythroblast	PBMC_24_CD8.CM	21076	62295	59210	41219	38134	-0.1359363	0.1989097	0.0831789
BMMC22_Erythroblast	PBMC_25_NK	20548	62295	57699	41747	37151	-0.1385436	0.1982623	0.08190738
BMMC22_Erythroblast	Islets_beta	17097	62295	63734	45198	46637	-0.2808326	0.06095713	-0.05394225
BMMC22_Erythroblast	Islets_alpha	17014	62295	65486	45281	48472	-0.2825945	0.0724267	-0.04411351
BMMC22_Erythroblast	Islets_delta	17411	62295	61673	44884	44262	-0.2578447	0.09019929	-0.02575176
BMMC22_Erythroblast	Islets_PP	16935	62295	63824	45360	46889	-0.2806173	0.07967934	-0.03782948
BMMC22_Erythroblast	Islets_acinar	18227	62295	66719	44068	48492	-0.2651327	0.07941877	-0.03644971
BMMC22_Erythroblast	Islets_duct	17742	62295	63744	44553	46002	-0.2554354	0.09899399	-0.01864199
BMMC22_Erythroblast	Islets_endothelial	17770	62295	64155	44525	46385	-0.2622809	0.08716437	-0.02857882
BMMC22_Erythroblast	Islets_immune	19656	62295	67939	42639	48283	-0.2341523	0.1063103	-0.008652037
BMMC22_Erythroblast	Islets_mesenchymal	17429	62295	62786	44866	45357	-0.26551	0.08236556	-0.03286741
BMMC22_Erythroblast	HCT116	18417	62295	64892	43878	46475	-0.2486106	0.09441342	-0.0219791
BMMC22_Erythroblast	WTC11_from_HPC_diff	16166	62295	58398	46129	42232	-0.2905446	0.05813637	-0.05632486
BMMC22_Erythroblast	Jurkat	19591	62295	58783	42704	39192	-0.2037499	0.1229787	0.01046654
BMMC22_G_M_prog	BMMC22_G_M_prog	63921	63921	63921	0	0	1	1	1
BMMC22_G_M_prog	BMMC22_HSC	39935	63921	64808	23986	24873	0.3089874	0.5032081	0.4105978
BMMC22_G_M_prog	BMMC22_ID2_hi_myeloid_prog	15551	63921	35748	48370	20197	-0.2251304	0.01943992	-0.07105162
BMMC22_G_M_prog	BMMC22_ILC	22840	63921	56304	41081	33464	-0.09437625	0.2253756	0.1141843
BMMC22_G_M_prog	BMMC22_Lymph_prog	34253	63921	66487	29668	32234	0.1512943	0.4018415	0.2986573
BMMC22_G_M_prog	BMMC22_MK_E_prog	33258	63921	63497	30663	30239	0.1517521	0.4085028	0.3036951
BMMC22_G_M_prog	BMMC22_Naive_CD20_pos_B	30993	63921	63355	32928	32362	0.09155903	0.366129	0.2605399
BMMC22_G_M_prog	BMMC22_NK	27317	63921	66621	36604	39304	-0.006371195	0.3045509	0.1919833
BMMC22_G_M_prog	BMMC22_Normoblast	18285	63921	56020	45636	37735	-0.2296385	0.1117604	-0.001009779
BMMC22_G_M_prog	BMMC22_pDC	34183	63921	61970	29738	27787	0.1761984	0.4155384	0.315048
BMMC22_G_M_prog	BMMC22_Plasma_cell	25952	63921	65478	37969	39526	-0.06270849	0.2480271	0.1368966
BMMC22_G_M_prog	BMMC22_Proerythroblast	26280	63921	63281	37641	37001	-0.02410987	0.2877298	0.1730186
BMMC22_G_M_prog	BMMC22_Transitional_B	29615	63921	63246	34306	33631	0.06142599	0.3506559	0.2414121
BMMC22_G_M_prog	PBMC5_B	29700	63921	61777	34221	32077	0.05944658	0.3359618	0.2304512
BMMC22_G_M_prog	PBMC5_DC	32572	63921	54841	31349	22269	0.1525918	0.3714279	0.2778973
BMMC22_G_M_prog	PBMC5_Mono	34881	63921	63455	29040	28574	0.1575005	0.3825648	0.2859748
BMMC22_G_M_prog	PBMC5_NK	23939	63921	58922	39982	34983	-0.07794245	0.2374556	0.1270422
BMMC22_G_M_prog	PBMC5_T	24634	63921	59027	39287	34393	-0.05721511	0.2463727	0.1375083
BMMC22_G_M_prog	PBMC_10_cDC	33606	63921	55848	30315	22242	0.1769411	0.3896597	0.2967101
BMMC22_G_M_prog	PBMC_11_CD14.Mono.1	31123	63921	59470	32798	28347	0.07946629	0.3280559	0.2299283
BMMC22_G_M_prog	PBMC_12_CD14.Mono.2	32842	63921	59397	31079	26555	0.1383793	0.3760505	0.2782203
BMMC22_G_M_prog	PBMC_13_CD16.Mono	30297	63921	54592	33624	24295	0.09852386	0.3400559	0.2424142
BMMC22_G_M_prog	PBMC_17_B	25805	63921	58277	38116	32472	-0.01212035	0.293907	0.1842936
BMMC22_G_M_prog	PBMC_20_CD4.N1	22704	63921	60378	41217	37674	-0.1147414	0.2151671	0.1028191
BMMC22_G_M_prog	PBMC_22_CD4.M	24523	63921	59146	39398	34623	-0.05410348	0.2557359	0.1452479
BMMC22_G_M_prog	PBMC_24_CD8.CM	24056	63921	59210	39865	35154	-0.06981113	0.2480347	0.1369452
BMMC22_G_M_prog	PBMC_25_NK	23562	63921	57699	40359	34137	-0.08029776	0.2361856	0.1254909
BMMC22_G_M_prog	Islets_beta	18271	63921	63734	45650	45463	-0.2570892	0.08731183	-0.0278745
BMMC22_G_M_prog	Islets_alpha	18325	63921	65486	45596	47161	-0.2529925	0.1034724	-0.01339537
BMMC22_G_M_prog	Islets_delta	19034	63921	61673	44887	42639	-0.218948	0.13165	0.01499406
BMMC22_G_M_prog	Islets_PP	18578	63921	63824	45343	45246	-0.2386317	0.1250073	0.006287307
BMMC22_G_M_prog	Islets_acinar	20154	63921	66719	43767	46565	-0.2135351	0.1329314	0.01579299
BMMC22_G_M_prog	Islets_duct	20250	63921	63744	43671	43494	-0.197768	0.1516974	0.03457484
BMMC22_G_M_prog	Islets_endothelial	21302	63921	64155	42619	42853	-0.1783961	0.1609009	0.04577869
BMMC22_G_M_prog	Islets_immune	29181	63921	67939	34740	38758	-0.02903734	0.2466008	0.143217
BMMC22_G_M_prog	Islets_mesenchymal	21222	63921	62786	42699	41564	-0.1725202	0.1642434	0.04979862
BMMC22_G_M_prog	HCT116	19883	63921	64892	44038	45009	-0.2145154	0.1280351	0.01217731
BMMC22_G_M_prog	WTC11_from_HPC_diff	18958	63921	58398	44963	39440	-0.205073	0.1480792	0.03144225
BMMC22_G_M_prog	Jurkat	21891	63921	58783	42030	36892	-0.1619592	0.1528334	0.04384598
BMMC22_HSC	BMMC22_HSC	64808	64808	64808	0	0	1	1	1
BMMC22_HSC	BMMC22_ID2_hi_myeloid_prog	13020	64808	35748	51788	22728	-0.2940571	-0.02026396	-0.1167165
BMMC22_HSC	BMMC22_ILC	23504	64808	56304	41304	32800	-0.0822891	0.2326045	0.1225632
BMMC22_HSC	BMMC22_Lymph_prog	34940	64808	66487	29868	31547	0.1625724	0.410905	0.3088832
BMMC22_HSC	BMMC22_MK_E_prog	36631	64808	63497	28177	26866	0.2249964	0.4527625	0.3537879
BMMC22_HSC	BMMC22_Naive_CD20_pos_B	30320	64808	63355	34488	33035	0.07199531	0.357848	0.2498975
BMMC22_HSC	BMMC22_NK	28284	64808	66621	36524	38337	0.005606409	0.3115819	0.2005433
BMMC22_HSC	BMMC22_Normoblast	18839	64808	56020	45969	37181	-0.2188918	0.1187423	0.007038286
BMMC22_HSC	BMMC22_pDC	32678	64808	61970	32130	29292	0.137763	0.3947964	0.2914474
BMMC22_HSC	BMMC22_Plasma_cell	25937	64808	65478	38871	39541	-0.07016747	0.2423309	0.1315385
BMMC22_HSC	BMMC22_Proerythroblast	27719	64808	63281	37089	35562	-0.0004048395	0.3004303	0.1884429
BMMC22_HSC	BMMC22_Transitional_B	29588	64808	63246	35220	33658	0.05414245	0.3462189	0.2365802
BMMC22_HSC	PBMC5_B	28733	64808	61777	36075	33044	0.02993987	0.3190562	0.211431
BMMC22_HSC	PBMC5_DC	26963	64808	54841	37845	27878	0.01395675	0.2891372	0.185674
BMMC22_HSC	PBMC5_Mono	27851	64808	63455	36957	35604	-0.01171587	0.2791004	0.1713545
BMMC22_HSC	PBMC5_NK	24390	64808	58922	40418	34532	-0.07456597	0.2380534	0.1286567
BMMC22_HSC	PBMC5_T	25669	64808	59027	39139	33358	-0.02988712	0.2684376	0.161029
BMMC22_HSC	PBMC_10_cDC	27938	64808	55848	36870	27910	0.03979504	0.3108348	0.2075113
BMMC22_HSC	PBMC_11_CD14.Mono.1	24146	64808	59470	40662	35324	-0.0913117	0.2215	0.1116518
BMMC22_HSC	PBMC_12_CD14.Mono.2	25695	64808	59397	39113	33702	-0.04010981	0.2645475	0.1547865
BMMC22_HSC	PBMC_13_CD16.Mono	24781	64808	54592	40027	29811	-0.04148534	0.2533983	0.1463923
BMMC22_HSC	PBMC_17_B	25485	64808	58277	39323	32792	-0.02612078	0.285468	0.1750833
BMMC22_HSC	PBMC_20_CD4.N1	23821	64808	60378	40987	36557	-0.0917953	0.2326688	0.1217453
BMMC22_HSC	PBMC_22_CD4.M	25645	64808	59146	39163	33501	-0.02443215	0.2798264	0.1708112
BMMC22_HSC	PBMC_24_CD8.CM	24931	64808	59210	39877	34279	-0.0514785	0.2625148	0.1525388
BMMC22_HSC	PBMC_25_NK	24078	64808	57699	40730	33621	-0.07444414	0.2379351	0.1286324
BMMC22_HSC	Islets_beta	19105	64808	63734	45703	44629	-0.2386665	0.1038535	-0.0108505
BMMC22_HSC	Islets_alpha	19087	64808	65486	45721	46399	-0.2353939	0.1215934	0.004659462
BMMC22_HSC	Islets_delta	20070	64808	61673	44738	41603	-0.1953335	0.1518157	0.03590059
BMMC22_HSC	Islets_PP	19570	64808	63824	45238	44254	-0.2166817	0.1439696	0.0259875
BMMC22_HSC	Islets_acinar	20702	64808	66719	44106	46017	-0.2022526	0.1455374	0.02839698
BMMC22_HSC	Islets_duct	20791	64808	63744	44017	42953	-0.1852198	0.1654382	0.0481111
BMMC22_HSC	Islets_endothelial	21903	64808	64155	42905	42252	-0.1730922	0.1629681	0.04898502
BMMC22_HSC	Islets_immune	26639	64808	67939	38169	41300	-0.08787751	0.2131737	0.105619
BMMC22_HSC	Islets_mesenchymal	21290	64808	62786	43518	41496	-0.1718194	0.1672361	0.05271625
BMMC22_HSC	HCT116	20530	64808	64892	44278	44362	-0.2083812	0.1312601	0.01640455
BMMC22_HSC	WTC11_from_HPC_diff	20337	64808	58398	44471	38061	-0.1733694	0.1714444	0.05616108
BMMC22_HSC	Jurkat	23284	64808	58783	41524	35499	-0.1374079	0.166506	0.0601152
BMMC22_ID2_hi_myeloid_prog	BMMC22_ID2_hi_myeloid_prog	35748	35748	35748	0	0	1	1	1
BMMC22_ID2_hi_myeloid_prog	BMMC22_ILC	12621	35748	56304	23127	43683	-0.237967	0.07898796	-0.0280284
BMMC22_ID2_hi_myeloid_prog	BMMC22_Lymph_prog	12829	35748	66487	22919	53658	-0.2878495	-0.006785039	-0.1050941
BMMC22_ID2_hi_myeloid_prog	BMMC22_MK_E_prog	12031	35748	63497	23717	51466	-0.3208706	-0.03555747	-0.1344787
BMMC22_ID2_hi_myeloid_prog	BMMC22_Naive_CD20_pos_B	13693	35748	63355	22055	49662	-0.2554138	0.02280615	-0.07455724
BMMC22_ID2_hi_myeloid_prog	BMMC22_NK	11670	35748	66621	24078	54951	-0.3057609	-0.005624597	-0.1085876
BMMC22_ID2_hi_myeloid_prog	BMMC22_Normoblast	11983	35748	56020	23765	44037	-0.2529663	0.07109626	-0.0377479
BMMC22_ID2_hi_myeloid_prog	BMMC22_pDC	12547	35748	61970	23201	49423	-0.3164595	-0.04512305	-0.1408426
BMMC22_ID2_hi_myeloid_prog	BMMC22_Plasma_cell	13124	35748	65478	22624	52354	-0.2568853	0.03622596	-0.06586942
BMMC22_ID2_hi_myeloid_prog	BMMC22_Proerythroblast	10238	35748	63281	25510	53043	-0.3817053	-0.08830164	-0.1894255
BMMC22_ID2_hi_myeloid_prog	BMMC22_Transitional_B	12165	35748	63246	23583	51081	-0.3045709	-0.0119217	-0.1119922
BMMC22_ID2_hi_myeloid_prog	PBMC5_B	14857	35748	61777	20891	46920	-0.1986704	0.08002423	-0.01827548
BMMC22_ID2_hi_myeloid_prog	PBMC5_DC	18158	35748	54841	17590	36683	-0.08438249	0.1522846	0.06129695
BMMC22_ID2_hi_myeloid_prog	PBMC5_Mono	18392	35748	63455	17356	45063	-0.1062438	0.1191287	0.03081223
BMMC22_ID2_hi_myeloid_prog	PBMC5_NK	12706	35748	58922	23042	46216	-0.2439638	0.06748335	-0.03782319
BMMC22_ID2_hi_myeloid_prog	PBMC5_T	11747	35748	59027	24001	47280	-0.2945365	0.01158513	-0.09203014
BMMC22_ID2_hi_myeloid_prog	PBMC_10_cDC	18280	35748	55848	17468	37568	-0.08715647	0.1503311	0.05942876
BMMC22_ID2_hi_myeloid_prog	PBMC_11_CD14.Mono.1	17787	35748	59470	17961	41683	-0.1040349	0.1379153	0.04666661
BMMC22_ID2_hi_myeloid_prog	PBMC_12_CD14.Mono.2	17897	35748	59397	17851	41500	-0.1103425	0.1228154	0.03288069
BMMC22_ID2_hi_myeloid_prog	PBMC_13_CD16.Mono	19113	35748	54592	16635	35479	-0.04639425	0.1818858	0.09159456
BMMC22_ID2_hi_myeloid_prog	PBMC_17_B	13282	35748	58277	22466	44995	-0.2392145	0.05861569	-0.04334686
BMMC22_ID2_hi_myeloid_prog	PBMC_20_CD4.N1	12227	35748	60378	23521	48151	-0.2571888	0.0635446	-0.04350761
BMMC22_ID2_hi_myeloid_prog	PBMC_22_CD4.M	11584	35748	59146	24164	47562	-0.3016763	0.00677201	-0.09736711
BMMC22_ID2_hi_myeloid_prog	PBMC_24_CD8.CM	12395	35748	59210	23353	46815	-0.2569487	0.05930327	-0.04643921
BMMC22_ID2_hi_myeloid_prog	PBMC_25_NK	12556	35748	57699	23192	45143	-0.2472448	0.06573379	-0.03986411
BMMC22_ID2_hi_myeloid_prog	Islets_beta	8901	35748	63734	26847	54833	-0.4148407	-0.1066399	-0.2098866
BMMC22_ID2_hi_myeloid_prog	Islets_alpha	8691	35748	65486	27057	56795	-0.4234594	-0.109943	-0.2130523
BMMC22_ID2_hi_myeloid_prog	Islets_delta	8961	35748	61673	26787	52712	-0.4094028	-0.09243516	-0.19641
BMMC22_ID2_hi_myeloid_prog	Islets_PP	8887	35748	63824	26861	54937	-0.4122243	-0.09009838	-0.1950856
BMMC22_ID2_hi_myeloid_prog	Islets_acinar	9330	35748	66719	26418	57389	-0.4041394	-0.09697872	-0.2000939
BMMC22_ID2_hi_myeloid_prog	Islets_duct	9541	35748	63744	26207	54203	-0.3964872	-0.0853989	-0.1883916
BMMC22_ID2_hi_myeloid_prog	Islets_endothelial	10789	35748	64155	24959	53366	-0.3428933	-0.02832005	-0.1327847
BMMC22_ID2_hi_myeloid_prog	Islets_immune	15336	35748	67939	20412	52603	-0.208479	0.05656439	-0.03821749
BMMC22_ID2_hi_myeloid_prog	Islets_mesenchymal	10125	35748	62786	25623	52661	-0.3753078	-0.06513187	-0.1675245
BMMC22_ID2_hi_myeloid_prog	HCT116	10406	35748	64892	25342	54486	-0.3377487	-0.01983849	-0.1266114
BMMC22_ID2_hi_myeloid_prog	WTC11_from_HPC_diff	7686	35748	58398	28062	50712	-0.4704106	-0.1545125	-0.2568789
BMMC22_ID2_hi_myeloid_prog	Jurkat	10703	35748	58783	25045	48080	-0.3165911	0.01001698	-0.09779273
BMMC22_ILC	BMMC22_ILC	56304	56304	56304	0	0	1	1	1
BMMC22_ILC	BMMC22_Lymph_prog	24360	56304	66487	31944	42127	-0.06151761	0.2525728	0.1419462
BMMC22_ILC	BMMC22_MK_E_prog	22671	56304	63497	33633	40826	-0.09640298	0.225485	0.1135766
BMMC22_ILC	BMMC22_Naive_CD20_pos_B	23860	56304	63355	32444	39495	-0.04965735	0.2736963	0.1604137
BMMC22_ILC	BMMC22_NK	33537	56304	66621	22767	33084	0.2057981	0.4402877	0.3432295
BMMC22_ILC	BMMC22_Normoblast	19741	56304	56020	36563	36279	-0.1199357	0.2235104	0.1077071
BMMC22_ILC	BMMC22_pDC	22573	56304	61970	33731	39397	-0.09604373	0.2229295	0.1120178
BMMC22_ILC	BMMC22_Plasma_cell	26028	56304	65478	30276	39450	-0.00531541	0.2962711	0.1868036
BMMC22_ILC	BMMC22_Proerythroblast	20188	56304	63281	36116	43093	-0.1633567	0.1739553	0.05882321
BMMC22_ILC	BMMC22_Transitional_B	22179	56304	63246	34125	41067	-0.09765155	0.2359364	0.1214747
BMMC22_ILC	PBMC5_B	25922	56304	61777	30382	35855	0.0223737	0.3282766	0.2171019
BMMC22_ILC	PBMC5_DC	21741	56304	54841	34563	33100	-0.05674788	0.2662193	0.1526798
BMMC22_ILC	PBMC5_Mono	21899	56304	63455	34405	41556	-0.09790503	0.2356008	0.1206709
BMMC22_ILC	PBMC5_NK	32688	56304	58922	23616	26234	0.2328437	0.4614856	0.3642267
BMMC22_ILC	PBMC5_T	27602	56304	59027	28702	31425	0.08440468	0.3570941	0.2538379
BMMC22_ILC	PBMC_10_cDC	22630	56304	55848	33674	33218	-0.03332334	0.2860775	0.173026
BMMC22_ILC	PBMC_11_CD14.Mono.1	19192	56304	59470	37112	40278	-0.1557724	0.1991448	0.08057043
BMMC22_ILC	PBMC_12_CD14.Mono.2	19372	56304	59397	36932	40025	-0.1502604	0.2011703	0.08304954
BMMC22_ILC	PBMC_13_CD16.Mono	20879	56304	54592	35425	33713	-0.07318137	0.260201	0.1446785
BMMC22_ILC	PBMC_17_B	23400	56304	58277	32904	34877	-0.02116685	0.3038077	0.1896751
BMMC22_ILC	PBMC_20_CD4.N1	27185	56304	60378	29119	33193	0.07218341	0.3650529	0.2573176
BMMC22_ILC	PBMC_22_CD4.M	26690	56304	59146	29614	32456	0.06011694	0.3454356	0.2395184
BMMC22_ILC	PBMC_24_CD8.CM	30793	56304	59210	25511	28417	0.179614	0.4292739	0.3293687
BMMC22_ILC	PBMC_25_NK	32418	56304	57699	23886	25281	0.2358445	0.4639589	0.3667714
BMMC22_ILC	Islets_beta	15243	56304	63734	41061	48491	-0.3072898	0.04877641	-0.06629847
BMMC22_ILC	Islets_alpha	14923	56304	65486	41381	50563	-0.3157229	0.05236436	-0.06412572
BMMC22_ILC	Islets_delta	15753	56304	61673	40551	45920	-0.2798483	0.08380498	-0.03277471
BMMC22_ILC	Islets_PP	15748	56304	63824	40556	48076	-0.2854364	0.08675194	-0.03152212
BMMC22_ILC	Islets_acinar	15900	56304	66719	40404	50819	-0.2971899	0.06302581	-0.05343151
BMMC22_ILC	Islets_duct	16212	56304	63744	40092	47532	-0.2751181	0.09000139	-0.02721087
BMMC22_ILC	Islets_endothelial	17867	56304	64155	38437	46288	-0.2319871	0.1246719	0.008539708
BMMC22_ILC	Islets_immune	20948	56304	67939	35356	46991	-0.1676599	0.170258	0.05666987
BMMC22_ILC	Islets_mesenchymal	16412	56304	62786	39892	46374	-0.2696779	0.08982495	-0.02577491
BMMC22_ILC	HCT116	17177	56304	64892	39127	47715	-0.2381168	0.1233157	0.004527009
BMMC22_ILC	WTC11_from_HPC_diff	14477	56304	58398	41827	43921	-0.3154007	0.04876317	-0.06636075
BMMC22_ILC	Jurkat	20376	56304	58783	35928	38407	-0.1341792	0.1992906	0.08649255
BMMC22_Lymph_prog	BMMC22_Lymph_prog	66487	66487	66487	0	0	1	1	1
BMMC22_Lymph_prog	BMMC22_MK_E_prog	30434	66487	63497	36053	33063	0.05887346	0.344328	0.2352235
BMMC22_Lymph_prog	BMMC22_Naive_CD20_pos_B	36000	66487	63355	30487	27355	0.2001618	0.4383866	0.3390452
BMMC22_Lymph_prog	BMMC22_NK	29395	66487	66621	37092	37226	0.02872667	0.3330098	0.221291
BMMC22_Lymph_prog	BMMC22_Normoblast	18677	66487	56020	47810	37343	-0.2232299	0.1204934	0.006925875
BMMC22_Lymph_prog	BMMC22_pDC	33680	66487	61970	32807	28290	0.1459935	0.3944126	0.292603
BMMC22_Lymph_prog	BMMC22_Plasma_cell	29134	66487	65478	37353	36344	0.002389759	0.2934593	0.1859006
BMMC22_Lymph_prog	BMMC22_Proerythroblast	25745	66487	63281	40742	37536	-0.05675135	0.2610138	0.1456907
BMMC22_Lymph_prog	BMMC22_Transitional_B	40635	66487	63246	25852	22611	0.3282545	0.5235652	0.4310991
BMMC22_Lymph_prog	PBMC5_B	33371	66487	61777	33116	28406	0.1362894	0.3882303	0.2868722
BMMC22_Lymph_prog	PBMC5_DC	26067	66487	54841	40420	28774	-0.008099024	0.2787252	0.1725013
BMMC22_Lymph_prog	PBMC5_Mono	26789	66487	63455	39698	36666	-0.04067965	0.2632702	0.1525129
BMMC22_Lymph_prog	PBMC5_NK	25769	66487	58922	40718	33153	-0.03806895	0.2706167	0.1609722
BMMC22_Lymph_prog	PBMC5_T	27197	66487	59027	39290	31830	0.00354729	0.2946881	0.1876209
BMMC22_Lymph_prog	PBMC_10_cDC	27766	66487	55848	38721	28082	0.0332606	0.3100197	0.2052225
BMMC22_Lymph_prog	PBMC_11_CD14.Mono.1	22646	66487	59470	43841	36824	-0.1340506	0.1919632	0.07925747
BMMC22_Lymph_prog	PBMC_12_CD14.Mono.2	23924	66487	59397	42563	35473	-0.09028378	0.2306253	0.1175419
BMMC22_Lymph_prog	PBMC_13_CD16.Mono	24018	66487	54592	42469	30574	-0.05945575	0.244299	0.1352955
BMMC22_Lymph_prog	PBMC_17_B	30443	66487	58277	36044	27834	0.09235603	0.3635804	0.2600203
BMMC22_Lymph_prog	PBMC_20_CD4.N1	25213	66487	60378	41274	35165	-0.06032276	0.2582465	0.14758
BMMC22_Lymph_prog	PBMC_22_CD4.M	27116	66487	59146	39371	32030	0.005325584	0.3026247	0.1939382
BMMC22_Lymph_prog	PBMC_24_CD8.CM	26575	66487	59210	39912	32635	-0.01257114	0.2942869	0.1845262
BMMC22_Lymph_prog	PBMC_25_NK	25444	66487	57699	41043	32255	-0.03809535	0.2704447	0.1608761
BMMC22_Lymph_prog	Islets_beta	18230	66487	63734	48257	45504	-0.2666683	0.08070592	-0.03481325
BMMC22_Lymph_prog	Islets_alpha	18216	66487	65486	48271	47270	-0.2676608	0.09165632	-0.02545598
BMMC22_Lymph_prog	Islets_delta	18915	66487	61673	47572	42758	-0.2330805	0.1200353	0.003172649
BMMC22_Lymph_prog	Islets_PP	18397	66487	63824	48090	45427	-0.2538889	0.1119376	-0.006727911
BMMC22_Lymph_prog	Islets_acinar	19201	66487	66719	47286	47518	-0.2478076	0.1071613	-0.01094607
BMMC22_Lymph_prog	Islets_duct	19241	66487	63744	47246	44503	-0.2304334	0.1281882	0.009601928
BMMC22_Lymph_prog	Islets_endothelial	20437	66487	64155	46050	43718	-0.2118152	0.1352687	0.01944799
BMMC22_Lymph_prog	Islets_immune	24778	66487	67939	41709	43161	-0.1357264	0.1810314	0.07038285
BMMC22_Lymph_prog	Islets_mesenchymal	19829	66487	62786	46658	42957	-0.2162262	0.1318599	0.01589508
BMMC22_Lymph_prog	HCT116	19221	66487	64892	47266	45671	-0.2429927	0.1076421	-0.009444995
BMMC22_Lymph_prog	WTC11_from_HPC_diff	18755	66487	58398	47732	39643	-0.2237251	0.1296479	0.01347989
BMMC22_Lymph_prog	Jurkat	23956	66487	58783	42531	34827	-0.1118026	0.1970026	0.08865587
BMMC22_MK_E_prog	BMMC22_MK_E_prog	63497	63497	63497	0	0	1	1	1
BMMC22_MK_E_prog	BMMC22_Naive_CD20_pos_B	26624	63497	63355	36873	36731	-0.01515069	0.2990207	0.1859801
BMMC22_MK_E_prog	BMMC22_NK	26557	63497	66621	36940	40064	-0.02904812	0.2879741	0.1741981
BMMC22_MK_E_prog	BMMC22_Normoblast	22122	63497	56020	41375	33898	-0.1284383	0.1842636	0.07724732
BMMC22_MK_E_prog	BMMC22_pDC	28076	63497	61970	35421	33894	0.02525748	0.3202918	0.2099644
BMMC22_MK_E_prog	BMMC22_Plasma_cell	24840	63497	65478	38657	40638	-0.08688416	0.2336999	0.1206653
BMMC22_MK_E_prog	BMMC22_Proerythroblast	36946	63497	63281	26551	26335	0.2384996	0.4548116	0.3587964
BMMC22_MK_E_prog	BMMC22_Transitional_B	26592	63497	63246	36905	36654	-0.01192123	0.3034632	0.189279
BMMC22_MK_E_prog	PBMC5_B	25587	63497	61777	37910	36190	-0.04176556	0.2717584	0.1594137
BMMC22_MK_E_prog	PBMC5_DC	23877	63497	54841	39620	30964	-0.05511354	0.2489885	0.1390594
BMMC22_MK_E_prog	PBMC5_Mono	24220	63497	63455	39277	39235	-0.09223101	0.2257118	0.1127994
BMMC22_MK_E_prog	PBMC5_NK	23566	63497	58922	39931	35356	-0.08706941	0.231719	0.1205219
BMMC22_MK_E_prog	PBMC5_T	24119	63497	59027	39378	34908	-0.06615828	0.2428122	0.1329654
BMMC22_MK_E_prog	PBMC_10_cDC	24686	63497	55848	38811	31162	-0.03558856	0.2659207	0.1561425
BMMC22_MK_E_prog	PBMC_11_CD14.Mono.1	21525	63497	59470	41972	37945	-0.1502974	0.1830632	0.06890572
BMMC22_MK_E_prog	PBMC_12_CD14.Mono.2	22520	63497	59397	40977	36877	-0.1134583	0.2154126	0.1007862
BMMC22_MK_E_prog	PBMC_13_CD16.Mono	22022	63497	54592	41475	32570	-0.1026629	0.2152084	0.1034741
BMMC22_MK_E_prog	PBMC_17_B	23367	63497	58277	40130	34910	-0.07479982	0.2533093	0.1393305
BMMC22_MK_E_prog	PBMC_20_CD4.N1	22710	63497	60378	40787	37668	-0.114565	0.2158159	0.1032458
BMMC22_MK_E_prog	PBMC_22_CD4.M	24089	63497	59146	39408	35057	-0.06041019	0.2541401	0.1427804
BMMC22_MK_E_prog	PBMC_24_CD8.CM	23576	63497	59210	39921	35634	-0.08252137	0.2398961	0.1277641
BMMC22_MK_E_prog	PBMC_25_NK	23241	63497	57699	40256	34458	-0.08831636	0.230471	0.1193218
BMMC22_MK_E_prog	Islets_beta	18256	63497	63734	45241	45478	-0.2543256	0.0910983	-0.02396166
BMMC22_MK_E_prog	Islets_alpha	18406	63497	65486	45091	47080	-0.2477131	0.1108569	-0.006119697
BMMC22_MK_E_prog	Islets_delta	19139	63497	61673	44358	42534	-0.2136086	0.1376766	0.02115141
BMMC22_MK_E_prog	Islets_PP	18886	63497	63824	44611	44938	-0.22831	0.1342764	0.01605449
BMMC22_MK_E_prog	Islets_acinar	20026	63497	66719	43471	46693	-0.2172058	0.1302575	0.01347545
BMMC22_MK_E_prog	Islets_duct	20018	63497	63744	43479	43726	-0.2010389	0.1508443	0.03363093
BMMC22_MK_E_prog	Islets_endothelial	20933	63497	64155	42564	43222	-0.1867052	0.1558073	0.04065004
BMMC22_MK_E_prog	Islets_immune	24182	63497	67939	39315	43757	-0.1374531	0.178896	0.06830855
BMMC22_MK_E_prog	Islets_mesenchymal	20388	63497	62786	43109	42398	-0.188564	0.1541739	0.03932135
BMMC22_MK_E_prog	HCT116	20428	63497	64892	43069	44464	-0.1998342	0.1408796	0.02542039
BMMC22_MK_E_prog	WTC11_from_HPC_diff	19493	63497	58398	44004	38905	-0.1896866	0.1596558	0.04390012
BMMC22_MK_E_prog	Jurkat	22502	63497	58783	40995	36281	-0.1445041	0.166454	0.05814128
BMMC22_Naive_CD20_pos_B	BMMC22_Naive_CD20_pos_B	63355	63355	63355	0	0	1	1	1
BMMC22_Naive_CD20_pos_B	BMMC22_NK	29464	63355	66621	33891	37157	0.0563462	0.3629075	0.2493382
BMMC22_Naive_CD20_pos_B	BMMC22_Normoblast	18393	63355	56020	44962	37627	-0.2114227	0.1401939	0.02443058
BMMC22_Naive_CD20_pos_B	BMMC22_pDC	32174	63355	61970	31181	29796	0.1420655	0.4033006	0.2994364
BMMC22_Naive_CD20_pos_B	BMMC22_Plasma_cell	30129	63355	65478	33226	35349	0.0545421	0.3374166	0.2311184
BMMC22_Naive_CD20_pos_B	BMMC22_Proerythroblast	23635	63355	63281	39720	39646	-0.09064443	0.2437907	0.1257927
BMMC22_Naive_CD20_pos_B	BMMC22_Transitional_B	37313	63355	63246	26042	25933	0.2703983	0.4925457	0.3953666
BMMC22_Naive_CD20_pos_B	PBMC5_B	40103	63355	61777	23252	21674	0.3439632	0.5300252	0.439063
BMMC22_Naive_CD20_pos_B	PBMC5_DC	27190	63355	54841	36165	27651	0.04116887	0.3192353	0.2145305
BMMC22_Naive_CD20_pos_B	PBMC5_Mono	28470	63355	63455	34885	34985	0.01989369	0.3111385	0.2027181
BMMC22_Naive_CD20_pos_B	PBMC5_NK	25356	63355	58922	37999	33566	-0.02654961	0.2881017	0.1764348
BMMC22_Naive_CD20_pos_B	PBMC5_T	27376	63355	59027	35979	31651	0.03279006	0.3268747	0.217902
BMMC22_Naive_CD20_pos_B	PBMC_10_cDC	29511	63355	55848	33844	26337	0.1010606	0.3616428	0.2597574
BMMC22_Naive_CD20_pos_B	PBMC_11_CD14.Mono.1	24434	63355	59470	38921	35036	-0.06711678	0.2499781	0.1387313
BMMC22_Naive_CD20_pos_B	PBMC_12_CD14.Mono.2	26109	63355	59397	37246	33288	-0.0144969	0.2926803	0.1818239
BMMC22_Naive_CD20_pos_B	PBMC_13_CD16.Mono	26095	63355	54592	37260	28497	0.01620681	0.3040741	0.1975739
BMMC22_Naive_CD20_pos_B	PBMC_17_B	37164	63355	58277	26191	21113	0.2990217	0.5033548	0.4103221
BMMC22_Naive_CD20_pos_B	PBMC_20_CD4.N1	25341	63355	60378	38014	35037	-0.03304225	0.2894686	0.1767021
BMMC22_Naive_CD20_pos_B	PBMC_22_CD4.M	27390	63355	59146	35965	31756	0.03798039	0.3375575	0.2271371
BMMC22_Naive_CD20_pos_B	PBMC_24_CD8.CM	26556	63355	59210	36799	32654	0.008872832	0.3190704	0.2075986
BMMC22_Naive_CD20_pos_B	PBMC_25_NK	24982	63355	57699	38373	32717	-0.02807848	0.2872312	0.1753543
BMMC22_Naive_CD20_pos_B	Islets_beta	16904	63355	63734	46451	46830	-0.2886324	0.06830849	-0.04853859
BMMC22_Naive_CD20_pos_B	Islets_alpha	17005	63355	65486	46350	48481	-0.2839902	0.08583014	-0.03313281
BMMC22_Naive_CD20_pos_B	Islets_delta	17525	63355	61673	45830	44148	-0.254552	0.1098494	-0.008678998
BMMC22_Naive_CD20_pos_B	Islets_PP	17229	63355	63824	46126	46595	-0.2715367	0.1038036	-0.01644214
BMMC22_Naive_CD20_pos_B	Islets_acinar	18127	63355	66719	45228	48592	-0.2610334	0.1027225	-0.01684927
BMMC22_Naive_CD20_pos_B	Islets_duct	18033	63355	63744	45322	45711	-0.2479212	0.1200253	0.0001434248
BMMC22_Naive_CD20_pos_B	Islets_endothelial	18650	63355	64155	44705	45505	-0.241921	0.1186445	0.0006665835
BMMC22_Naive_CD20_pos_B	Islets_immune	24362	63355	67939	38993	43577	-0.1295922	0.1899944	0.07954935
BMMC22_Naive_CD20_pos_B	Islets_mesenchymal	18100	63355	62786	45255	44686	-0.246935	0.1135592	-0.004101712
BMMC22_Naive_CD20_pos_B	HCT116	17998	63355	64892	45357	46894	-0.2566598	0.1034959	-0.01518858
BMMC22_Naive_CD20_pos_B	WTC11_from_HPC_diff	16679	63355	58398	46676	41719	-0.2645919	0.1032809	-0.01478188
BMMC22_Naive_CD20_pos_B	Jurkat	20458	63355	58783	42897	38325	-0.1846822	0.1496549	0.03701909
BMMC22_NK	BMMC22_NK	66621	66621	66621	0	0	1	1	1
BMMC22_NK	BMMC22_Normoblast	19370	66621	56020	47251	36650	-0.1863173	0.1625089	0.04676944
BMMC22_NK	BMMC22_pDC	27405	66621	61970	39216	34565	0.005156731	0.3123097	0.2004926
BMMC22_NK	BMMC22_Plasma_cell	27606	66621	65478	39015	37872	-0.0181731	0.2921635	0.1806532
BMMC22_NK	BMMC22_Proerythroblast	24456	66621	63281	42165	38825	-0.08374699	0.2468786	0.129835
BMMC22_NK	BMMC22_Transitional_B	26596	66621	63246	40025	36650	-0.01825438	0.3070185	0.1911491
BMMC22_NK	PBMC5_B	29451	66621	61777	37170	32326	0.06247273	0.3605071	0.2492536
BMMC22_NK	PBMC5_DC	23087	66621	54841	43534	31754	-0.06346928	0.2565378	0.1434369
BMMC22_NK	PBMC5_Mono	25441	66621	63455	41180	38014	-0.05459264	0.2694015	0.1539441
BMMC22_NK	PBMC5_NK	37499	66621	58922	29122	21423	0.2748609	0.4796339	0.3872694
BMMC22_NK	PBMC5_T	34545	66621	59027	32076	24482	0.2130234	0.4469037	0.3487548
BMMC22_NK	PBMC_10_cDC	24193	66621	55848	42428	31655	-0.03425979	0.2819496	0.1689805
BMMC22_NK	PBMC_11_CD14.Mono.1	20741	66621	59470	45880	38729	-0.1648539	0.1847425	0.0666975
BMMC22_NK	PBMC_12_CD14.Mono.2	22036	66621	59397	44585	37361	-0.1239165	0.2189853	0.1008859
BMMC22_NK	PBMC_13_CD16.Mono	22250	66621	54592	44371	32342	-0.08286275	0.2453395	0.1306322
BMMC22_NK	PBMC_17_B	26075	66621	58277	40546	32202	-0.0009815611	0.318716	0.2046484
BMMC22_NK	PBMC_20_CD4.N1	29075	66621	60378	37546	31303	0.04962995	0.3433034	0.2356042
BMMC22_NK	PBMC_22_CD4.M	33529	66621	59146	33092	25617	0.187141	0.4357887	0.3343905
BMMC22_NK	PBMC_24_CD8.CM	36106	66621	59210	30515	23104	0.2523447	0.476455	0.3803013
BMMC22_NK	PBMC_25_NK	37039	66621	57699	29582	20660	0.2759285	0.4801214	0.3880501
BMMC22_NK	Islets_beta	17876	66621	63734	48745	45858	-0.2719661	0.08166731	-0.0350854
BMMC22_NK	Islets_alpha	17805	66621	65486	48816	47681	-0.2740552	0.09126787	-0.02695513
BMMC22_NK	Islets_delta	18430	66621	61673	48191	43243	-0.2402024	0.1197354	0.001504548
BMMC22_NK	Islets_PP	17820	66621	63824	48801	46004	-0.265656	0.1078638	-0.01239048
BMMC22_NK	Islets_acinar	18722	66621	66719	47899	47997	-0.2563137	0.1049252	-0.01429145
BMMC22_NK	Islets_duct	18320	66621	63744	48301	45424	-0.2493414	0.1179592	-0.001781962
BMMC22_NK	Islets_endothelial	19125	66621	64155	47496	45030	-0.2357358	0.1242053	0.006194721
BMMC22_NK	Islets_immune	22433	66621	67939	44188	45506	-0.1812659	0.1578582	0.04344802
BMMC22_NK	Islets_mesenchymal	18607	66621	62786	48014	44179	-0.242267	0.116076	-0.001094682
BMMC22_NK	HCT116	18692	66621	64892	47929	46200	-0.2492327	0.1094432	-0.009184573
BMMC22_NK	WTC11_from_HPC_diff	17030	66621	58398	49591	41368	-0.2689681	0.09408188	-0.02305074
BMMC22_NK	Jurkat	22865	66621	58783	43756	35918	-0.1259842	0.1962841	0.08541843
BMMC22_Normoblast	BMMC22_Normoblast	56020	56020	56020	0	0	1	1	1
BMMC22_Normoblast	BMMC22_pDC	17375	56020	61970	38645	44595	-0.2508295	0.09263118	-0.02026462
BMMC22_Normoblast	BMMC22_Plasma_cell	20027	56020	65478	35993	45451	-0.1666995	0.1757442	0.06047774
BMMC22_Normoblast	BMMC22_Proerythroblast	23747	56020	63281	32273	39534	-0.08550765	0.2127774	0.1076328
BMMC22_Normoblast	BMMC22_Transitional_B	17822	56020	63246	38198	45424	-0.2289898	0.1249582	0.009125666
BMMC22_Normoblast	PBMC5_B	19446	56020	61777	36574	42331	-0.1685893	0.1787315	0.06253717
BMMC22_Normoblast	PBMC5_DC	17870	56020	54841	38150	36971	-0.1736318	0.1734887	0.05720023
BMMC22_Normoblast	PBMC5_Mono	17789	56020	63455	38231	45666	-0.2218777	0.1309552	0.01414974
BMMC22_Normoblast	PBMC5_NK	19640	56020	58922	36380	39282	-0.1386958	0.2080079	0.0920919
BMMC22_Normoblast	PBMC5_T	18842	56020	59027	37178	40185	-0.1767277	0.1607334	0.04804958
BMMC22_Normoblast	PBMC_10_cDC	18292	56020	55848	37728	37556	-0.1675053	0.1795458	0.06320159
BMMC22_Normoblast	PBMC_11_CD14.Mono.1	16623	56020	59470	39397	42847	-0.2358002	0.1297218	0.01076671
BMMC22_Normoblast	PBMC_12_CD14.Mono.2	16459	56020	59397	39561	42938	-0.2401611	0.123761	0.005125555
BMMC22_Normoblast	PBMC_13_CD16.Mono	17372	56020	54592	38648	37220	-0.1841359	0.1696075	0.0519609
BMMC22_Normoblast	PBMC_17_B	18224	56020	58277	37796	40053	-0.1852688	0.1699043	0.05280696
BMMC22_Normoblast	PBMC_20_CD4.N1	19675	56020	60378	36345	40703	-0.1484128	0.2000925	0.08438739
BMMC22_Normoblast	PBMC_22_CD4.M	18764	56020	59146	37256	40382	-0.1783114	0.1631045	0.04950159
BMMC22_Normoblast	PBMC_24_CD8.CM	19538	56020	59210	36482	39672	-0.1465677	0.1996795	0.08452501
BMMC22_Normoblast	PBMC_25_NK	19505	56020	57699	36515	38194	-0.1343818	0.2125524	0.09639736
BMMC22_Normoblast	Islets_beta	14015	56020	63734	42005	49719	-0.3443509	0.0124947	-0.1014872
BMMC22_Normoblast	Islets_alpha	13745	56020	65486	42275	51741	-0.3532188	0.01391658	-0.1011959
BMMC22_Normoblast	Islets_delta	14362	56020	61673	41658	47311	-0.3258446	0.03787098	-0.07735846
BMMC22_Normoblast	Islets_PP	14317	56020	63824	41703	49507	-0.3328212	0.03895643	-0.07766012
BMMC22_Normoblast	Islets_acinar	14681	56020	66719	41339	52038	-0.340332	0.01799191	-0.09643245
BMMC22_Normoblast	Islets_duct	14873	56020	63744	41147	48871	-0.3184646	0.04663801	-0.06911423
BMMC22_Normoblast	Islets_endothelial	15922	56020	64155	40098	48233	-0.2894587	0.07071256	-0.04436497
BMMC22_Normoblast	Islets_immune	17842	56020	67939	38178	50097	-0.2548804	0.09520368	-0.01870007
BMMC22_Normoblast	Islets_mesenchymal	14713	56020	62786	41307	48073	-0.3215721	0.04012845	-0.07419964
BMMC22_Normoblast	HCT116	15987	56020	64892	40033	48905	-0.2788347	0.08223539	-0.03475941
BMMC22_Normoblast	WTC11_from_HPC_diff	12828	56020	58398	43192	45570	-0.3731558	-0.01134012	-0.124175
BMMC22_Normoblast	Jurkat	16854	56020	58783	39166	41929	-0.2342291	0.1189942	0.003549958
BMMC22_pDC	BMMC22_pDC	61970	61970	61970	0	0	1	1	1
BMMC22_pDC	BMMC22_Plasma_cell	27457	61970	65478	34513	38021	-0.01872182	0.2746892	0.1671441
BMMC22_pDC	BMMC22_Proerythroblast	24200	61970	63281	37770	39081	-0.07055839	0.2530982	0.1368741
BMMC22_pDC	BMMC22_Transitional_B	31732	61970	63246	30238	31514	0.1237465	0.3888282	0.2841541
BMMC22_pDC	PBMC5_B	30368	61970	61777	31602	31409	0.08686666	0.3526184	0.2490493
BMMC22_pDC	PBMC5_DC	27581	61970	54841	34389	27260	0.03584861	0.29926	0.1975793
BMMC22_pDC	PBMC5_Mono	27638	61970	63455	34332	35817	-0.002627683	0.2824145	0.1755251
BMMC22_pDC	PBMC5_NK	23580	61970	58922	38390	35342	-0.08424659	0.2275727	0.1180655
BMMC22_pDC	PBMC5_T	25236	61970	59027	36734	33791	-0.03105901	0.2659078	0.1582513
BMMC22_pDC	PBMC_10_cDC	28653	61970	55848	33317	27195	0.06164256	0.3191569	0.2182019
BMMC22_pDC	PBMC_11_CD14.Mono.1	23833	61970	59470	38137	35637	-0.08558657	0.2248032	0.1150821
BMMC22_pDC	PBMC_12_CD14.Mono.2	25398	61970	59397	36572	33999	-0.03575814	0.2657067	0.1563859
BMMC22_pDC	PBMC_13_CD16.Mono	24732	61970	54592	37238	29860	-0.03149603	0.2561337	0.1502724
BMMC22_pDC	PBMC_17_B	27180	61970	58277	34790	31097	0.02916977	0.3185078	0.2120451
BMMC22_pDC	PBMC_20_CD4.N1	23146	61970	60378	38824	37232	-0.09410318	0.2311054	0.1194479
BMMC22_pDC	PBMC_22_CD4.M	25236	61970	59146	36734	33910	-0.02131692	0.2827206	0.1730423
BMMC22_pDC	PBMC_24_CD8.CM	24360	61970	59210	37610	34850	-0.05752057	0.253855	0.144318
BMMC22_pDC	PBMC_25_NK	23237	61970	57699	38733	34462	-0.08494912	0.2281504	0.1184522
BMMC22_pDC	Islets_beta	16698	61970	63734	45272	47036	-0.2948533	0.05309855	-0.06182735
BMMC22_pDC	Islets_alpha	16926	61970	65486	45044	48560	-0.2849043	0.07586309	-0.04121383
BMMC22_pDC	Islets_delta	17549	61970	61673	44421	44124	-0.2543518	0.1009011	-0.01570123
BMMC22_pDC	Islets_PP	17146	61970	63824	44824	46678	-0.2698549	0.09835118	-0.02029231
BMMC22_pDC	Islets_acinar	18027	61970	66719	43943	48692	-0.2612004	0.09475467	-0.02316757
BMMC22_pDC	Islets_duct	18028	61970	63744	43942	45716	-0.2437935	0.1179939	-0.0007062785
BMMC22_pDC	Islets_endothelial	18754	61970	64155	43216	45401	-0.2392116	0.1111195	-0.004663226
BMMC22_pDC	Islets_immune	24404	61970	67939	37566	43535	-0.1286434	0.1800614	0.07150401
BMMC22_pDC	Islets_mesenchymal	18254	61970	62786	43716	44532	-0.2449667	0.104722	-0.0107054
BMMC22_pDC	HCT116	17814	61970	64892	44156	47078	-0.2662294	0.0826941	-0.03338926
BMMC22_pDC	WTC11_from_HPC_diff	17610	61970	58398	44360	40788	-0.233569	0.1267067	0.009372825
BMMC22_pDC	Jurkat	21554	61970	58783	40416	37229	-0.1725725	0.1372102	0.03006998
BMMC22_Plasma_cell	BMMC22_Plasma_cell	65478	65478	65478	0	0	1	1	1
BMMC22_Plasma_cell	BMMC22_Proerythroblast	22192	65478	63281	43286	41089	-0.1472664	0.1887738	0.07226866
BMMC22_Plasma_cell	BMMC22_Transitional_B	28282	65478	63246	37196	34964	0.009001391	0.3064045	0.1975531
BMMC22_Plasma_cell	PBMC5_B	32169	65478	61777	33309	29608	0.112583	0.3711604	0.2684887
BMMC22_Plasma_cell	PBMC5_DC	24394	65478	54841	41084	30447	-0.03783856	0.2664357	0.1560092
BMMC22_Plasma_cell	PBMC5_Mono	24111	65478	63455	41367	39344	-0.09446848	0.2304958	0.1163358
BMMC22_Plasma_cell	PBMC5_NK	26518	65478	58922	38960	32404	-0.005451047	0.2972331	0.187809
BMMC22_Plasma_cell	PBMC5_T	26576	65478	59027	38902	32451	-0.01238545	0.2789035	0.1725322
BMMC22_Plasma_cell	PBMC_10_cDC	26377	65478	55848	39101	29471	0.01231887	0.3041255	0.1955449
BMMC22_Plasma_cell	PBMC_11_CD14.Mono.1	21273	65478	59470	44205	38197	-0.1465078	0.1983675	0.08096305
BMMC22_Plasma_cell	PBMC_12_CD14.Mono.2	21617	65478	59397	43861	37780	-0.1340618	0.2073039	0.09043315
BMMC22_Plasma_cell	PBMC_13_CD16.Mono	22978	65478	54592	42500	31614	-0.0678623	0.2497742	0.137026
BMMC22_Plasma_cell	PBMC_17_B	30030	65478	58277	35448	28247	0.08791621	0.3592128	0.255122
BMMC22_Plasma_cell	PBMC_20_CD4.N1	26848	65478	60378	38630	33530	-0.007891808	0.2994634	0.1896932
BMMC22_Plasma_cell	PBMC_22_CD4.M	26387	65478	59146	39091	32759	-0.01378887	0.2845763	0.1766293
BMMC22_Plasma_cell	PBMC_24_CD8.CM	27477	65478	59210	38001	31733	0.01791147	0.3137841	0.2058243
BMMC22_Plasma_cell	PBMC_25_NK	26096	65478	57699	39382	31603	-0.01005589	0.2923759	0.1832501
BMMC22_Plasma_cell	Islets_beta	16970	65478	63734	48508	46764	-0.2929379	0.06051104	-0.05533662
BMMC22_Plasma_cell	Islets_alpha	16737	65478	65486	48741	48749	-0.3005833	0.06477869	-0.05237449
BMMC22_Plasma_cell	Islets_delta	17547	65478	61673	47931	44126	-0.2621346	0.09707758	-0.01980894
BMMC22_Plasma_cell	Islets_PP	17478	65478	63824	48000	46346	-0.2735419	0.09610711	-0.02259728
BMMC22_Plasma_cell	Islets_acinar	18408	65478	66719	47070	48311	-0.262293	0.09654771	-0.02166838
BMMC22_Plasma_cell	Islets_duct	18483	65478	63744	46995	45261	-0.2467603	0.1146837	-0.003612395
BMMC22_Plasma_cell	Islets_endothelial	19747	65478	64155	45731	44408	-0.2210762	0.1322325	0.01503453
BMMC22_Plasma_cell	Islets_immune	23570	65478	67939	41908	44369	-0.1544986	0.1732852	0.06031509
BMMC22_Plasma_cell	Islets_mesenchymal	18105	65478	62786	47373	44681	-0.2587555	0.09681666	-0.0195491
BMMC22_Plasma_cell	HCT116	19322	65478	64892	46156	45570	-0.2241737	0.1313799	0.01267251
BMMC22_Plasma_cell	WTC11_from_HPC_diff	16509	65478	58398	48969	41889	-0.281938	0.0802027	-0.03592453
BMMC22_Plasma_cell	Jurkat	20964	65478	58783	44514	37819	-0.1692057	0.16425	0.05134834
BMMC22_Proerythroblast	BMMC22_Proerythroblast	63281	63281	63281	0	0	1	1	1
BMMC22_Proerythroblast	BMMC22_Transitional_B	23264	63281	63246	40017	39982	-0.1017914	0.2346671	0.116276
BMMC22_Proerythroblast	PBMC5_B	22393	63281	61777	40888	39384	-0.1237764	0.2103666	0.09364699
BMMC22_Proerythroblast	PBMC5_DC	19934	63281	54841	43347	34907	-0.1598635	0.1709225	0.05574766
BMMC22_Proerythroblast	PBMC5_Mono	20944	63281	63455	42337	42511	-0.174203	0.1636254	0.04606979
BMMC22_Proerythroblast	PBMC5_NK	21148	63281	58922	42133	37774	-0.1497345	0.1844762	0.06969749
BMMC22_Proerythroblast	PBMC5_T	22410	63281	59027	40871	36617	-0.1165095	0.2016732	0.08928052
BMMC22_Proerythroblast	PBMC_10_cDC	20579	63281	55848	42702	35269	-0.1445956	0.1847454	0.06950537
BMMC22_Proerythroblast	PBMC_11_CD14.Mono.1	18400	63281	59470	44881	41070	-0.2244504	0.1291129	0.01022282
BMMC22_Proerythroblast	PBMC_12_CD14.Mono.2	19370	63281	59397	43911	40027	-0.1935165	0.1554313	0.03625328
BMMC22_Proerythroblast	PBMC_13_CD16.Mono	18901	63281	54592	44380	35691	-0.1847785	0.1537262	0.03742955
BMMC22_Proerythroblast	PBMC_17_B	20518	63281	58277	42763	37759	-0.1544105	0.1893092	0.0720582
BMMC22_Proerythroblast	PBMC_20_CD4.N1	20503	63281	60378	42778	39875	-0.1722457	0.1716249	0.05591838
BMMC22_Proerythroblast	PBMC_22_CD4.M	22339	63281	59146	40942	36807	-0.1136959	0.2112607	0.09702681
BMMC22_Proerythroblast	PBMC_24_CD8.CM	21623	63281	59210	41658	37587	-0.136264	0.1972256	0.08253219
BMMC22_Proerythroblast	PBMC_25_NK	20901	63281	57699	42380	36798	-0.1492565	0.1847892	0.07015146
BMMC22_Proerythroblast	Islets_beta	17478	63281	63734	45803	46256	-0.274986	0.07149055	-0.04434712
BMMC22_Proerythroblast	Islets_alpha	17778	63281	65486	45503	47708	-0.265429	0.09305219	-0.02472511
BMMC22_Proerythroblast	Islets_delta	18212	63281	61673	45069	43461	-0.2373585	0.1154388	-0.001980607
BMMC22_Proerythroblast	Islets_PP	17797	63281	63824	45484	46027	-0.2582981	0.1064868	-0.01263758
BMMC22_Proerythroblast	Islets_acinar	19246	63281	66719	44035	47473	-0.2374531	0.1113578	-0.006330236
BMMC22_Proerythroblast	Islets_duct	18842	63281	63744	44439	44902	-0.231269	0.1253308	0.006621802
BMMC22_Proerythroblast	Islets_endothelial	18614	63281	64155	44667	45541	-0.245447	0.1056898	-0.01102483
BMMC22_Proerythroblast	Islets_immune	20735	63281	67939	42546	47204	-0.2157427	0.12245	0.007444313
BMMC22_Proerythroblast	Islets_mesenchymal	18598	63281	62786	44683	44188	-0.2379651	0.1119399	-0.004611763
BMMC22_Proerythroblast	HCT116	19295	63281	64892	43986	45597	-0.2349071	0.1066186	-0.009383364
BMMC22_Proerythroblast	WTC11_from_HPC_diff	18034	63281	58398	45247	40364	-0.2307976	0.1237095	0.006881795
BMMC22_Proerythroblast	Jurkat	20526	63281	58783	42755	38257	-0.2006878	0.1192439	0.008844663
BMMC22_Transitional_B	BMMC22_Transitional_B	63246	63246	63246	0	0	1	1	1
BMMC22_Transitional_B	PBMC5_B	32990	63246	61777	30256	28787	0.1586342	0.4113987	0.3097402
BMMC22_Transitional_B	PBMC5_DC	24448	63246	54841	38798	30393	-0.03198947	0.2702846	0.1610677
BMMC22_Transitional_B	PBMC5_Mono	24695	63246	63455	38551	38760	-0.07465202	0.2455703	0.1319231
BMMC22_Transitional_B	PBMC5_NK	23451	63246	58922	39795	35471	-0.07670424	0.2515977	0.1380557
BMMC22_Transitional_B	PBMC5_T	24324	63246	59027	38922	34703	-0.05597359	0.2569506	0.1458334
BMMC22_Transitional_B	PBMC_10_cDC	26281	63246	55848	36965	29567	0.01616538	0.3076772	0.199917
BMMC22_Transitional_B	PBMC_11_CD14.Mono.1	21523	63246	59470	41723	37947	-0.1414693	0.1968876	0.0815845
BMMC22_Transitional_B	PBMC_12_CD14.Mono.2	22719	63246	59397	40527	36678	-0.1000767	0.2330258	0.1175679
BMMC22_Transitional_B	PBMC_13_CD16.Mono	22949	63246	54592	40297	31643	-0.07159126	0.2434025	0.1321558
BMMC22_Transitional_B	PBMC_17_B	31431	63246	58277	31815	26846	0.1444411	0.4038727	0.3020035
BMMC22_Transitional_B	PBMC_20_CD4.N1	23068	63246	60378	40178	37310	-0.09133434	0.2460953	0.1313253
BMMC22_Transitional_B	PBMC_22_CD4.M	24361	63246	59146	38885	34785	-0.04998088	0.2683339	0.1557258
BMMC22_Transitional_B	PBMC_24_CD8.CM	24035	63246	59210	39211	35175	-0.06246959	0.264377	0.1508745
BMMC22_Transitional_B	PBMC_25_NK	23183	63246	57699	40063	34516	-0.07455518	0.2539079	0.1403132
BMMC22_Transitional_B	Islets_beta	16658	63246	63734	46588	47076	-0.2936825	0.06290696	-0.05379702
BMMC22_Transitional_B	Islets_alpha	16723	63246	65486	46523	48763	-0.2913938	0.07705716	-0.04147305
BMMC22_Transitional_B	Islets_delta	17403	63246	61673	45843	44270	-0.2553089	0.1096628	-0.009233141
BMMC22_Transitional_B	Islets_PP	17196	63246	63824	46050	46628	-0.2688405	0.106709	-0.01364585
BMMC22_Transitional_B	Islets_acinar	17610	63246	66719	45636	49109	-0.2715686	0.09335433	-0.02628519
BMMC22_Transitional_B	Islets_duct	17678	63246	63744	45568	46066	-0.2569976	0.111849	-0.008217294
BMMC22_Transitional_B	Islets_endothelial	18620	63246	64155	44626	45535	-0.2387813	0.1213472	0.00334531
BMMC22_Transitional_B	Islets_immune	22686	63246	67939	40560	45253	-0.1633548	0.1686627	0.05551575
BMMC22_Transitional_B	Islets_mesenchymal	17747	63246	62786	45499	45039	-0.2537947	0.1088401	-0.009262382
BMMC22_Transitional_B	HCT116	17716	63246	64892	45530	47176	-0.2660548	0.09316119	-0.02524211
BMMC22_Transitional_B	WTC11_from_HPC_diff	17237	63246	58398	46009	41161	-0.250174	0.1149399	-0.00306824
BMMC22_Transitional_B	Jurkat	21140	63246	58783	42106	37643	-0.1664878	0.161499	0.04993169
PBMC5_B	PBMC5_B	61777	61777	61777	0	0	1	1	1
PBMC5_B	PBMC5_DC	29192	61777	54841	32585	25649	0.1150484	0.3731392	0.2707885
PBMC5_B	PBMC5_Mono	29917	61777	63455	31860	33538	0.08088256	0.3587422	0.2520696
PBMC5_B	PBMC5_NK	28533	61777	58922	33244	30389	0.08060014	0.3707958	0.262011
PBMC5_B	PBMC5_T	30245	61777	59027	31532	28782	0.1293917	0.3979608	0.29279
PBMC5_B	PBMC_10_cDC	32421	61777	55848	29356	23427	0.2099344	0.4423639	0.3440894
PBMC5_B	PBMC_11_CD14.Mono.1	25341	61777	59470	36436	34129	-0.02740273	0.2815031	0.1710056
PBMC5_B	PBMC_12_CD14.Mono.2	26570	61777	59397	35207	32827	0.01281611	0.3139921	0.2038724
PBMC5_B	PBMC_13_CD16.Mono	28041	61777	54592	33736	26551	0.0925039	0.3648085	0.2597567
PBMC5_B	PBMC_17_B	46941	61777	58277	14836	11336	0.5987051	0.7008003	0.626962
PBMC5_B	PBMC_20_CD4.N1	28782	61777	60378	32995	31596	0.08172517	0.3768247	0.2676305
PBMC5_B	PBMC_22_CD4.M	30096	61777	59146	31681	29050	0.131993	0.4073268	0.3005079
PBMC5_B	PBMC_24_CD8.CM	30170	61777	59210	31607	29040	0.1277534	0.4070964	0.2997636
PBMC5_B	PBMC_25_NK	28026	61777	57699	33751	29673	0.07541774	0.366846	0.2580303
PBMC5_B	Islets_beta	16986	61777	63734	44791	46748	-0.27695	0.07836978	-0.03822753
PBMC5_B	Islets_alpha	16946	61777	65486	44831	48540	-0.2780349	0.08895475	-0.02925185
PBMC5_B	Islets_delta	17570	61777	61673	44207	44103	-0.2462828	0.1151103	-0.002757006
PBMC5_B	Islets_PP	17347	61777	63824	44430	46477	-0.2600263	0.112451	-0.007360696
PBMC5_B	Islets_acinar	18028	61777	66719	43749	48691	-0.2575605	0.1018531	-0.01664032
PBMC5_B	Islets_duct	18104	61777	63744	43673	45640	-0.2420412	0.1203131	0.001643365
PBMC5_B	Islets_endothelial	19076	61777	64155	42701	45079	-0.2206585	0.1356398	0.01821221
PBMC5_B	Islets_immune	25194	61777	67939	36583	42745	-0.09390578	0.2187615	0.1087503
PBMC5_B	Islets_mesenchymal	18097	61777	62786	43680	44689	-0.2417237	0.1149568	-0.001768192
PBMC5_B	HCT116	18140	61777	64892	43637	46752	-0.2357601	0.1260304	0.006487865
PBMC5_B	WTC11_from_HPC_diff	15957	61777	58398	45820	42441	-0.283494	0.08281617	-0.03436252
PBMC5_B	Jurkat	21024	61777	58783	40753	37759	-0.1498268	0.1840501	0.07087969
PBMC5_DC	PBMC5_DC	54841	54841	54841	0	0	1	1	1
PBMC5_DC	PBMC5_Mono	37086	54841	63455	17755	26369	0.3181954	0.4963647	0.4083615
PBMC5_DC	PBMC5_NK	23159	54841	58922	31682	35763	-0.02676063	0.2873441	0.1753566
PBMC5_DC	PBMC5_T	22312	54841	59027	32529	36715	-0.06029627	0.2494626	0.1392406
PBMC5_DC	PBMC_10_cDC	44542	54841	55848	10299	11306	0.6127173	0.6909641	0.6210889
PBMC5_DC	PBMC_11_CD14.Mono.1	33487	54841	59470	21354	25983	0.2396648	0.4481792	0.3550349
PBMC5_DC	PBMC_12_CD14.Mono.2	35321	54841	59397	19520	24076	0.3047607	0.4935082	0.4032318
PBMC5_DC	PBMC_13_CD16.Mono	35042	54841	54592	19799	19550	0.3327522	0.506983	0.4187756
PBMC5_DC	PBMC_17_B	25534	54841	58277	29307	32743	0.04056699	0.3314128	0.2235273
PBMC5_DC	PBMC_20_CD4.N1	22177	54841	60378	32664	38201	-0.06024228	0.2676636	0.1538116
PBMC5_DC	PBMC_22_CD4.M	22073	54841	59146	32768	37073	-0.06291286	0.2534738	0.1416977
PBMC5_DC	PBMC_24_CD8.CM	22886	54841	59210	31955	36324	-0.0357352	0.2822418	0.1699494
PBMC5_DC	PBMC_25_NK	22813	54841	57699	32028	34886	-0.02901313	0.2867503	0.1744382
PBMC5_DC	Islets_beta	15424	54841	63734	39417	48310	-0.292421	0.05689498	-0.05794174
PBMC5_DC	Islets_alpha	15354	54841	65486	39487	50132	-0.2957073	0.06423702	-0.05175737
PBMC5_DC	Islets_delta	15983	54841	61673	38858	45690	-0.2634887	0.09276601	-0.02322057
PBMC5_DC	Islets_PP	15858	54841	63824	38983	47966	-0.2715192	0.09476636	-0.02300394
PBMC5_DC	Islets_acinar	16863	54841	66719	37978	49856	-0.2597408	0.09052314	-0.02555726
PBMC5_DC	Islets_duct	17409	54841	63744	37432	46335	-0.2311499	0.1217455	0.005433935
PBMC5_DC	Islets_endothelial	18411	54841	64155	36430	45744	-0.2064038	0.1393117	0.02434784
PBMC5_DC	Islets_immune	27922	54841	67939	26919	40017	0.001994104	0.2667586	0.1662825
PBMC5_DC	Islets_mesenchymal	17794	54841	62786	37047	44992	-0.2241295	0.1204935	0.006593642
PBMC5_DC	HCT116	17275	54841	64892	37566	47617	-0.2249403	0.1284123	0.01048378
PBMC5_DC	WTC11_from_HPC_diff	14619	54841	58398	40222	43779	-0.2987051	0.06357454	-0.0526275
PBMC5_DC	Jurkat	17663	54841	58783	37178	41120	-0.209833	0.1305962	0.01666965
PBMC5_Mono	PBMC5_Mono	63455	63455	63455	0	0	1	1	1
PBMC5_Mono	PBMC5_NK	23965	63455	58922	39490	34957	-0.05196873	0.2727468	0.1585926
PBMC5_Mono	PBMC5_T	24708	63455	59027	38747	34319	-0.03855209	0.2713894	0.1595925
PBMC5_Mono	PBMC_10_cDC	38278	63455	55848	25177	17570	0.3434361	0.5134673	0.4267019
PBMC5_Mono	PBMC_11_CD14.Mono.1	42466	63455	59470	20989	17004	0.4053069	0.5515499	0.4692862
PBMC5_Mono	PBMC_12_CD14.Mono.2	50646	63455	59397	12809	8751	0.6515299	0.7221208	0.656897
PBMC5_Mono	PBMC_13_CD16.Mono	40461	63455	54592	22994	14131	0.4196572	0.5655529	0.4833563
PBMC5_Mono	PBMC_17_B	25360	63455	58277	38095	32917	-0.01819343	0.2932089	0.1815168
PBMC5_Mono	PBMC_20_CD4.N1	22843	63455	60378	40612	37535	-0.09251083	0.2440342	0.1289155
PBMC5_Mono	PBMC_22_CD4.M	24446	63455	59146	39009	34700	-0.04185244	0.275299	0.1618619
PBMC5_Mono	PBMC_24_CD8.CM	24209	63455	59210	39246	35001	-0.0480552	0.2745722	0.160954
PBMC5_Mono	PBMC_25_NK	23595	63455	57699	39860	34104	-0.05354754	0.2720948	0.157832
PBMC5_Mono	Islets_beta	16661	63455	63734	46794	47073	-0.2957746	0.05630003	-0.06029314
PBMC5_Mono	Islets_alpha	16630	63455	65486	46825	48856	-0.2987688	0.06430257	-0.05374143
PBMC5_Mono	Islets_delta	17100	63455	61673	46355	44573	-0.2670082	0.09325051	-0.02490184
PBMC5_Mono	Islets_PP	16560	63455	63824	46895	47264	-0.2882781	0.08365368	-0.03627266
PBMC5_Mono	Islets_acinar	18190	63455	66719	45265	48529	-0.2644125	0.08901204	-0.02882851
PBMC5_Mono	Islets_duct	18458	63455	63744	44997	45286	-0.2405652	0.1161698	-0.001941339
PBMC5_Mono	Islets_endothelial	18834	63455	64155	44621	45321	-0.2359739	0.1166857	-4.264782e-05
PBMC5_Mono	Islets_immune	28610	63455	67939	34845	39329	-0.0360051	0.2433083	0.1396652
PBMC5_Mono	Islets_mesenchymal	19177	63455	62786	44278	43609	-0.2241377	0.1220361	0.006583882
PBMC5_Mono	HCT116	17575	63455	64892	45880	47317	-0.2649929	0.09231013	-0.02623719
PBMC5_Mono	WTC11_from_HPC_diff	15018	63455	58398	48437	43380	-0.3184642	0.04801589	-0.06975718
PBMC5_Mono	Jurkat	18178	63455	58783	45277	40605	-0.240149	0.1045691	-0.01023258
PBMC5_NK	PBMC5_NK	58922	58922	58922	0	0	1	1	1
PBMC5_NK	PBMC5_T	31906	58922	59027	27016	27121	0.1961033	0.4371499	0.3385212
PBMC5_NK	PBMC_10_cDC	24163	58922	55848	34759	31685	0.001178721	0.311612	0.2000316
PBMC5_NK	PBMC_11_CD14.Mono.1	20387	58922	59470	38535	39083	-0.1389629	0.2095247	0.0920288
PBMC5_NK	PBMC_12_CD14.Mono.2	20823	58922	59397	38099	38574	-0.1201051	0.2252911	0.1078854
PBMC5_NK	PBMC_13_CD16.Mono	22490	58922	54592	36432	32102	-0.0371202	0.2870085	0.1728079
PBMC5_NK	PBMC_17_B	25421	58922	58277	33501	32856	0.01947642	0.3330246	0.2206622
PBMC5_NK	PBMC_20_CD4.N1	30075	58922	60378	28847	30303	0.1392117	0.4116525	0.3072783
PBMC5_NK	PBMC_22_CD4.M	30941	58922	59146	27981	28205	0.1673068	0.4213938	0.3200711
PBMC5_NK	PBMC_24_CD8.CM	35402	58922	59210	23520	23808	0.2997542	0.5141718	0.4192127
PBMC5_NK	PBMC_25_NK	53561	58922	57699	5361	4138	0.8581904	0.8809245	0.8397278
PBMC5_NK	Islets_beta	16011	58922	63734	42911	47723	-0.2941778	0.06344853	-0.05243183
PBMC5_NK	Islets_alpha	15760	58922	65486	43162	49726	-0.3019775	0.066377	-0.05072585
PBMC5_NK	Islets_delta	16609	58922	61673	42313	45064	-0.2629951	0.1002545	-0.01674025
PBMC5_NK	Islets_PP	16434	58922	63824	42488	47390	-0.2768883	0.0951453	-0.02322897
PBMC5_NK	Islets_acinar	16766	58922	66719	42156	49953	-0.2810413	0.08121604	-0.03628068
PBMC5_NK	Islets_duct	16878	58922	63744	42044	46866	-0.2651927	0.1003908	-0.0172711
PBMC5_NK	Islets_endothelial	18306	58922	64155	40616	45849	-0.2281959	0.1299044	0.01318816
PBMC5_NK	Islets_immune	21760	58922	67939	37162	46179	-0.1592263	0.1771633	0.06388534
PBMC5_NK	Islets_mesenchymal	17090	58922	62786	41832	45696	-0.2567751	0.1036917	-0.01226011
PBMC5_NK	HCT116	17399	58922	64892	41523	47493	-0.2424458	0.1213694	0.00239206
PBMC5_NK	WTC11_from_HPC_diff	14669	58922	58398	44253	43729	-0.3157296	0.05060526	-0.06514131
PBMC5_NK	Jurkat	20965	58922	58783	37957	37818	-0.1265424	0.2078984	0.09496612
PBMC5_T	PBMC5_T	59027	59027	59027	0	0	1	1	1
PBMC5_T	PBMC_10_cDC	23490	59027	55848	35537	32358	-0.02804435	0.2757215	0.1663117
PBMC5_T	PBMC_11_CD14.Mono.1	19554	59027	59470	39473	39916	-0.1680741	0.1735591	0.05856699
PBMC5_T	PBMC_12_CD14.Mono.2	20830	59027	59397	38197	38567	-0.1313282	0.2021886	0.08745485
PBMC5_T	PBMC_13_CD16.Mono	21530	59027	54592	37497	33062	-0.0777149	0.2404988	0.1285894
PBMC5_T	PBMC_17_B	26463	59027	58277	32564	31814	0.04489744	0.3416606	0.2323894
PBMC5_T	PBMC_20_CD4.N1	35898	59027	60378	23129	24480	0.2959415	0.5037845	0.4107429
PBMC5_T	PBMC_22_CD4.M	52426	59027	59146	6601	6720	0.8134012	0.8457377	0.796925
PBMC5_T	PBMC_24_CD8.CM	39855	59027	59210	19172	19355	0.4405159	0.6037405	0.51857
PBMC5_T	PBMC_25_NK	31547	59027	57699	27480	26152	0.1945356	0.4352342	0.3367534
PBMC5_T	Islets_beta	17646	59027	63734	41381	46088	-0.2592593	0.07861609	-0.03395696
PBMC5_T	Islets_alpha	17404	59027	65486	41623	48082	-0.2670629	0.08245156	-0.03138313
PBMC5_T	Islets_delta	17935	59027	61673	41092	43738	-0.2347813	0.1105797	-0.003445886
PBMC5_T	Islets_PP	17203	59027	63824	41824	46621	-0.2582653	0.1007345	-0.01522835
PBMC5_T	Islets_acinar	18052	59027	66719	40975	48667	-0.254381	0.09041731	-0.02415758
PBMC5_T	Islets_duct	17584	59027	63744	41443	46160	-0.2486102	0.1049634	-0.01064166
PBMC5_T	Islets_endothelial	18179	59027	64155	40848	45976	-0.2374448	0.1110587	-0.003196033
PBMC5_T	Islets_immune	21176	59027	67939	37851	46763	-0.1802245	0.1476227	0.03676169
PBMC5_T	Islets_mesenchymal	17625	59027	62786	41402	45161	-0.2467928	0.1011988	-0.01257966
PBMC5_T	HCT116	18261	59027	64892	40766	46631	-0.2315393	0.1139188	-0.0009840534
PBMC5_T	WTC11_from_HPC_diff	15962	59027	58398	43065	42436	-0.2829846	0.06890126	-0.04424421
PBMC5_T	Jurkat	22958	59027	58783	36069	35825	-0.08687402	0.2198089	0.1125968
PBMC_10_cDC	PBMC_10_cDC	55848	55848	55848	0	0	1	1	1
PBMC_10_cDC	PBMC_11_CD14.Mono.1	34124	55848	59470	21724	25346	0.2504702	0.4561383	0.3631159
PBMC_10_cDC	PBMC_12_CD14.Mono.2	35917	55848	59397	19931	23480	0.3113185	0.4976793	0.4076724
PBMC_10_cDC	PBMC_13_CD16.Mono	35479	55848	54592	20369	19113	0.3310905	0.5051368	0.4165996
PBMC_10_cDC	PBMC_17_B	27947	55848	58277	27901	30330	0.1086491	0.3809752	0.2761771
PBMC_10_cDC	PBMC_20_CD4.N1	23190	55848	60378	32658	37188	-0.03258436	0.2912259	0.1778895
PBMC_10_cDC	PBMC_22_CD4.M	23320	55848	59146	32528	35826	-0.02895139	0.2812766	0.1702714
PBMC_10_cDC	PBMC_24_CD8.CM	23940	55848	59210	31908	35270	-0.004437656	0.3097681	0.1977688
PBMC_10_cDC	PBMC_25_NK	23837	55848	57699	32011	33862	0.0002907555	0.3126094	0.2005516
PBMC_10_cDC	Islets_beta	15899	55848	63734	39949	47835	-0.2805554	0.06907627	-0.04599742
PBMC_10_cDC	Islets_alpha	15821	55848	65486	40027	49665	-0.282812	0.07874135	-0.03783599
PBMC_10_cDC	Islets_delta	16433	55848	61673	39415	45240	-0.2510584	0.1062736	-0.01022282
PBMC_10_cDC	Islets_PP	16322	55848	63824	39526	47502	-0.2610494	0.1059076	-0.01222791
PBMC_10_cDC	Islets_acinar	17443	55848	66719	38405	49276	-0.2452457	0.10507	-0.01135343
PBMC_10_cDC	Islets_duct	17992	55848	63744	37856	45752	-0.2178176	0.1345286	0.018002
PBMC_10_cDC	Islets_endothelial	18933	55848	64155	36915	45222	-0.1909897	0.1551606	0.03984187
PBMC_10_cDC	Islets_immune	28577	55848	67939	27271	39362	0.01885614	0.2819543	0.1812219
PBMC_10_cDC	Islets_mesenchymal	18389	55848	62786	37459	44397	-0.2102816	0.1332706	0.01923557
PBMC_10_cDC	HCT116	17830	55848	64892	38018	47062	-0.2139207	0.1383696	0.02045978
PBMC_10_cDC	WTC11_from_HPC_diff	15025	55848	58398	40823	43373	-0.2886056	0.07391139	-0.04235534
PBMC_10_cDC	Jurkat	18445	55848	58783	37403	40338	-0.191272	0.1481117	0.03406772
PBMC_11_CD14.Mono.1	PBMC_11_CD14.Mono.1	59470	59470	59470	0	0	1	1	1
PBMC_11_CD14.Mono.1	PBMC_12_CD14.Mono.2	42447	59470	59397	17023	16950	0.4501982	0.586063	0.5049022
PBMC_11_CD14.Mono.1	PBMC_13_CD16.Mono	34858	59470	54592	24612	19734	0.2832557	0.4766139	0.3857346
PBMC_11_CD14.Mono.1	PBMC_17_B	22126	59470	58277	37344	36151	-0.08826514	0.2459002	0.1312488
PBMC_11_CD14.Mono.1	PBMC_20_CD4.N1	19299	59470	60378	40171	41079	-0.1734492	0.187063	0.06821888
PBMC_11_CD14.Mono.1	PBMC_22_CD4.M	19450	59470	59146	40020	39696	-0.1674784	0.1802825	0.06358949
PBMC_11_CD14.Mono.1	PBMC_24_CD8.CM	19965	59470	59210	39505	39245	-0.1517549	0.200164	0.08272145
PBMC_11_CD14.Mono.1	PBMC_25_NK	20039	59470	57699	39431	37660	-0.1425152	0.2069555	0.08928568
PBMC_11_CD14.Mono.1	Islets_beta	14822	59470	63734	44648	48912	-0.3284389	0.03354381	-0.08341968
PBMC_11_CD14.Mono.1	Islets_alpha	14725	59470	65486	44745	50761	-0.3318548	0.04140787	-0.07697156
PBMC_11_CD14.Mono.1	Islets_delta	15216	59470	61673	44254	46457	-0.30325	0.06705411	-0.0513741
PBMC_11_CD14.Mono.1	Islets_PP	15057	59470	63824	44413	48767	-0.3148918	0.06461	-0.05534299
PBMC_11_CD14.Mono.1	Islets_acinar	16337	59470	66719	43133	50382	-0.2960822	0.06709318	-0.05101908
PBMC_11_CD14.Mono.1	Islets_duct	16900	59470	63744	42570	46844	-0.2683876	0.09671471	-0.02137666
PBMC_11_CD14.Mono.1	Islets_endothelial	17693	59470	64155	41777	46462	-0.2487633	0.112211	-0.005153536
PBMC_11_CD14.Mono.1	Islets_immune	26617	59470	67939	32853	41322	-0.06060711	0.2312552	0.126383
PBMC_11_CD14.Mono.1	Islets_mesenchymal	17459	59470	62786	42011	45327	-0.2567051	0.09869923	-0.01677484
PBMC_11_CD14.Mono.1	HCT116	16521	59470	64892	42949	48371	-0.2727409	0.09366554	-0.0261038
PBMC_11_CD14.Mono.1	WTC11_from_HPC_diff	13646	59470	58398	45824	44752	-0.3421367	0.03420344	-0.08416803
PBMC_11_CD14.Mono.1	Jurkat	15898	59470	58783	43572	42885	-0.2853612	0.07436323	-0.04237312
PBMC_12_CD14.Mono.2	PBMC_12_CD14.Mono.2	59397	59397	59397	0	0	1	1	1
PBMC_12_CD14.Mono.2	PBMC_13_CD16.Mono	37114	59397	54592	22283	17478	0.3560326	0.5267042	0.4392814
PBMC_12_CD14.Mono.2	PBMC_17_B	23175	59397	58277	36222	35102	-0.0532045	0.2744173	0.159869
PBMC_12_CD14.Mono.2	PBMC_20_CD4.N1	19647	59397	60378	39750	40731	-0.1620936	0.1949444	0.07638388
PBMC_12_CD14.Mono.2	PBMC_22_CD4.M	20740	59397	59146	38657	38406	-0.1296275	0.2105257	0.0939869
PBMC_12_CD14.Mono.2	PBMC_24_CD8.CM	20750	59397	59210	38647	38460	-0.1266461	0.2190527	0.101986
PBMC_12_CD14.Mono.2	PBMC_25_NK	20507	59397	57699	38890	37192	-0.1226384	0.2235192	0.1060163
PBMC_12_CD14.Mono.2	Islets_beta	15550	59397	63734	43847	48184	-0.3085705	0.04999604	-0.06725411
PBMC_12_CD14.Mono.2	Islets_alpha	15589	59397	65486	43808	49897	-0.3094487	0.0584155	-0.05984211
PBMC_12_CD14.Mono.2	Islets_delta	16071	59397	61673	43326	45602	-0.2789874	0.08802404	-0.03084182
PBMC_12_CD14.Mono.2	Islets_PP	15707	59397	63824	43690	48117	-0.2931912	0.08434722	-0.03622194
PBMC_12_CD14.Mono.2	Islets_acinar	17259	59397	66719	42138	49460	-0.269346	0.08964783	-0.02871567
PBMC_12_CD14.Mono.2	Islets_duct	17646	59397	63744	41751	46098	-0.2427904	0.119928	0.001143045
PBMC_12_CD14.Mono.2	Islets_endothelial	17997	59397	64155	41400	46158	-0.2382121	0.1202919	0.002882108
PBMC_12_CD14.Mono.2	Islets_immune	27568	59397	67939	31829	40371	-0.03034218	0.2547895	0.1504084
PBMC_12_CD14.Mono.2	Islets_mesenchymal	18246	59397	62786	41151	44540	-0.2301424	0.12193	0.006045134
PBMC_12_CD14.Mono.2	HCT116	16759	59397	64892	42638	48133	-0.2659398	0.0970689	-0.02237835
PBMC_12_CD14.Mono.2	WTC11_from_HPC_diff	14339	59397	58398	45058	44059	-0.3180149	0.05658993	-0.06252838
PBMC_12_CD14.Mono.2	Jurkat	16273	59397	58783	43124	42510	-0.277297	0.07822044	-0.03815471
PBMC_13_CD16.Mono	PBMC_13_CD16.Mono	54592	54592	54592	0	0	1	1	1
PBMC_13_CD16.Mono	PBMC_17_B	24369	54592	58277	30223	33908	0.01196997	0.3157191	0.2054166
PBMC_13_CD16.Mono	PBMC_20_CD4.N1	21298	54592	60378	33294	39080	-0.07721622	0.2606861	0.1447859
PBMC_13_CD16.Mono	PBMC_22_CD4.M	21378	54592	59146	33214	37768	-0.07825936	0.2460717	0.132634
PBMC_13_CD16.Mono	PBMC_24_CD8.CM	21943	54592	59210	32649	37267	-0.05858759	0.2694633	0.1553512
PBMC_13_CD16.Mono	PBMC_25_NK	22144	54592	57699	32448	35555	-0.04104599	0.2843038	0.1699216
PBMC_13_CD16.Mono	Islets_beta	14647	54592	63734	39945	49087	-0.3086496	0.04716636	-0.06888202
PBMC_13_CD16.Mono	Islets_alpha	14583	54592	65486	40009	50903	-0.3135843	0.05251497	-0.064638
PBMC_13_CD16.Mono	Islets_delta	15044	54592	61673	39548	46629	-0.2865736	0.07679373	-0.04050447
PBMC_13_CD16.Mono	Islets_PP	14915	54592	63824	39677	48909	-0.293894	0.07963271	-0.03949643
PBMC_13_CD16.Mono	Islets_acinar	15799	54592	66719	38793	50920	-0.2856098	0.07132306	-0.04579327
PBMC_13_CD16.Mono	Islets_duct	16243	54592	63744	38349	47501	-0.2600308	0.1009463	-0.01670312
PBMC_13_CD16.Mono	Islets_endothelial	17216	54592	64155	37376	46939	-0.2328247	0.1235234	0.006664605
PBMC_13_CD16.Mono	Islets_immune	26168	54592	67939	28424	41771	-0.03493095	0.2458278	0.1424106
PBMC_13_CD16.Mono	Islets_mesenchymal	16764	54592	62786	37828	46022	-0.2494419	0.1023548	-0.01269776
PBMC_13_CD16.Mono	HCT116	16054	54592	64892	38538	48838	-0.2556342	0.1065224	-0.01273189
PBMC_13_CD16.Mono	WTC11_from_HPC_diff	13533	54592	58398	41059	44865	-0.3263419	0.04289507	-0.07421102
PBMC_13_CD16.Mono	Jurkat	16623	54592	58783	37969	42160	-0.2348084	0.1160871	0.0001757393
PBMC_17_B	PBMC_17_B	58277	58277	58277	0	0	1	1	1
PBMC_17_B	PBMC_20_CD4.N1	25770	58277	60378	32507	34608	0.02508783	0.3413344	0.2287112
PBMC_17_B	PBMC_22_CD4.M	26262	58277	59146	32015	32884	0.04538935	0.3492798	0.2382932
PBMC_17_B	PBMC_24_CD8.CM	26625	58277	59210	31652	32585	0.0520537	0.3576925	0.2464461
PBMC_17_B	PBMC_25_NK	25005	58277	57699	33272	32694	0.01660837	0.3314412	0.2188266
PBMC_17_B	Islets_beta	15895	58277	63734	42382	47839	-0.2916026	0.06836809	-0.04837576
PBMC_17_B	Islets_alpha	15845	58277	65486	42432	49641	-0.292828	0.079058	-0.03933439
PBMC_17_B	Islets_delta	16459	58277	61673	41818	45214	-0.2625317	0.1043616	-0.01374739
PBMC_17_B	Islets_PP	16286	58277	63824	41991	47538	-0.2741535	0.1029085	-0.01694356
PBMC_17_B	Islets_acinar	16846	58277	66719	41431	49873	-0.2714917	0.09321643	-0.02551665
PBMC_17_B	Islets_duct	16939	58277	63744	41338	46805	-0.2569293	0.1127215	-0.006593104
PBMC_17_B	Islets_endothelial	17703	58277	64155	40574	46452	-0.2396896	0.1237533	0.005829047
PBMC_17_B	Islets_immune	22380	58277	67939	35897	45559	-0.1408009	0.1900501	0.07760903
PBMC_17_B	Islets_mesenchymal	16757	58277	62786	41520	46029	-0.2616789	0.1028257	-0.01450144
PBMC_17_B	HCT116	17098	58277	64892	41179	47794	-0.2458563	0.1210174	0.0008607305
PBMC_17_B	WTC11_from_HPC_diff	15136	58277	58398	43141	43262	-0.2926763	0.07815055	-0.03925618
PBMC_17_B	Jurkat	19150	58277	58783	39127	39633	-0.1800851	0.1656941	0.05101691
PBMC_20_CD4.N1	PBMC_20_CD4.N1	60378	60378	60378	0	0	1	1	1
PBMC_20_CD4.N1	PBMC_22_CD4.M	35547	60378	59146	24831	23599	0.29263	0.5076447	0.412902
PBMC_20_CD4.N1	PBMC_24_CD8.CM	33933	60378	59210	26445	25277	0.2463181	0.4830767	0.3842066
PBMC_20_CD4.N1	PBMC_25_NK	29709	60378	57699	30669	27990	0.1412677	0.4148623	0.3100957
PBMC_20_CD4.N1	Islets_beta	16006	60378	63734	44372	47728	-0.3017394	0.05784054	-0.05759278
PBMC_20_CD4.N1	Islets_alpha	15785	60378	65486	44593	49701	-0.3090006	0.06227096	-0.05462245
PBMC_20_CD4.N1	Islets_delta	16524	60378	61673	43854	45149	-0.2733504	0.09279805	-0.02393935
PBMC_20_CD4.N1	Islets_PP	16509	60378	63824	43869	47315	-0.2824147	0.0922772	-0.02594391
PBMC_20_CD4.N1	Islets_acinar	16615	60378	66719	43763	50104	-0.2938832	0.07202571	-0.04537757
PBMC_20_CD4.N1	Islets_duct	16814	60378	63744	43564	46930	-0.2761968	0.09275684	-0.02502238
PBMC_20_CD4.N1	Islets_endothelial	18276	60378	64155	42102	45879	-0.2358853	0.1268464	0.009831656
PBMC_20_CD4.N1	Islets_immune	21017	60378	67939	39361	46922	-0.1873771	0.1576674	0.04353765
PBMC_20_CD4.N1	Islets_mesenchymal	16685	60378	62786	43693	46101	-0.2762656	0.08875431	-0.02736917
PBMC_20_CD4.N1	HCT116	17794	60378	64892	42584	47098	-0.2397047	0.1269252	0.007824004
PBMC_20_CD4.N1	WTC11_from_HPC_diff	15028	60378	58398	45350	43370	-0.311829	0.0563048	-0.05923313
PBMC_20_CD4.N1	Jurkat	21551	60378	58783	38827	37232	-0.119399	0.2146851	0.1023814
PBMC_22_CD4.M	PBMC_22_CD4.M	59146	59146	59146	0	0	1	1	1
PBMC_22_CD4.M	PBMC_24_CD8.CM	37382	59146	59210	21764	21828	0.3663942	0.5599051	0.4687048
PBMC_22_CD4.M	PBMC_25_NK	30543	59146	57699	28603	27156	0.1644699	0.4188919	0.3175897
PBMC_22_CD4.M	Islets_beta	17557	59146	63734	41589	46177	-0.2583299	0.08493222	-0.0290078
PBMC_22_CD4.M	Islets_alpha	17322	59146	65486	41824	48164	-0.2657255	0.08915696	-0.02604894
PBMC_22_CD4.M	Islets_delta	17880	59146	61673	41266	43793	-0.2332071	0.1172429	0.001908038
PBMC_22_CD4.M	Islets_PP	17221	59146	63824	41925	46603	-0.2564731	0.1065784	-0.01042587
PBMC_22_CD4.M	Islets_acinar	17958	59146	66719	41188	48761	-0.2549727	0.09464768	-0.02111517
PBMC_22_CD4.M	Islets_duct	17533	59146	63744	41613	46211	-0.2464006	0.1128746	-0.004178779
PBMC_22_CD4.M	Islets_endothelial	18147	59146	64155	40999	46008	-0.2340345	0.119692	0.004136464
PBMC_22_CD4.M	Islets_immune	21013	59146	67939	38133	46926	-0.1811234	0.1525023	0.04021328
PBMC_22_CD4.M	Islets_mesenchymal	17627	59146	62786	41519	45159	-0.2439511	0.1086137	-0.006437626
PBMC_22_CD4.M	HCT116	18170	59146	64892	40976	46722	-0.2318877	0.1190118	0.002727459
PBMC_22_CD4.M	WTC11_from_HPC_diff	16028	59146	58398	43118	42370	-0.277182	0.07934536	-0.0351495
PBMC_22_CD4.M	Jurkat	22796	59146	58783	36350	35987	-0.08796701	0.2236387	0.1152373
PBMC_24_CD8.CM	PBMC_24_CD8.CM	59210	59210	59210	0	0	1	1	1
PBMC_24_CD8.CM	PBMC_25_NK	35021	59210	57699	24189	22678	0.2997736	0.5135057	0.4188798
PBMC_24_CD8.CM	Islets_beta	16736	59210	63734	42474	46998	-0.2749926	0.08057059	-0.03482861
PBMC_24_CD8.CM	Islets_alpha	16490	59210	65486	42720	48996	-0.2832991	0.08335973	-0.03332122
PBMC_24_CD8.CM	Islets_delta	17101	59210	61673	42109	44572	-0.2520669	0.1094977	-0.007104778
PBMC_24_CD8.CM	Islets_PP	16797	59210	63824	42413	47027	-0.2653069	0.1076111	-0.01091167
PBMC_24_CD8.CM	Islets_acinar	17315	59210	66719	41895	49404	-0.2654661	0.09567328	-0.02152959
PBMC_24_CD8.CM	Islets_duct	17364	59210	63744	41846	46380	-0.2519945	0.1134206	-0.004170113
PBMC_24_CD8.CM	Islets_endothelial	18432	59210	64155	40778	45723	-0.2246249	0.1352952	0.01850687
PBMC_24_CD8.CM	Islets_immune	21598	59210	67939	37612	46341	-0.1641347	0.1748071	0.06112507
PBMC_24_CD8.CM	Islets_mesenchymal	17201	59210	62786	42009	45585	-0.2537114	0.1088474	-0.007398562
PBMC_24_CD8.CM	HCT116	18123	59210	64892	41087	46769	-0.2243891	0.1361785	0.01792591
PBMC_24_CD8.CM	WTC11_from_HPC_diff	15236	59210	58398	43974	43162	-0.2996588	0.06631883	-0.04923288
PBMC_24_CD8.CM	Jurkat	22346	59210	58783	36864	36437	-0.08625152	0.2412212	0.1291993
PBMC_25_NK	PBMC_25_NK	57699	57699	57699	0	0	1	1	1
PBMC_25_NK	Islets_beta	15904	57699	63734	41795	47830	-0.2903371	0.06718323	-0.04868052
PBMC_25_NK	Islets_alpha	15629	57699	65486	42070	49857	-0.2996179	0.0684122	-0.04854623
PBMC_25_NK	Islets_delta	16489	57699	61673	41210	45184	-0.2600109	0.1031937	-0.01374815
PBMC_25_NK	Islets_PP	16296	57699	63824	41403	47528	-0.2750427	0.09666931	-0.02156726
PBMC_25_NK	Islets_acinar	16638	57699	66719	41061	50081	-0.2778799	0.08421527	-0.03328151
PBMC_25_NK	Islets_duct	16740	57699	63744	40959	47004	-0.2631391	0.1021054	-0.01544515
PBMC_25_NK	Islets_endothelial	18082	57699	64155	39617	46073	-0.2277791	0.1307222	0.01410547
PBMC_25_NK	Islets_immune	21489	57699	67939	36210	46450	-0.1586308	0.178052	0.06476536
PBMC_25_NK	Islets_mesenchymal	16964	57699	62786	40735	45822	-0.2543813	0.105825	-0.01002016
PBMC_25_NK	HCT116	17259	57699	64892	40440	47633	-0.2404774	0.122408	0.003670601
PBMC_25_NK	WTC11_from_HPC_diff	14591	57699	58398	43108	43807	-0.3141419	0.05182939	-0.06389965
PBMC_25_NK	Jurkat	20820	57699	58783	36879	37963	-0.1233186	0.2107027	0.09783062
Islets_beta	Islets_beta	63734	63734	63734	0	0	1	1	1
Islets_beta	Islets_alpha	38180	63734	65486	25554	27306	0.3041279	0.5176313	0.4221744
Islets_beta	Islets_delta	40052	63734	61673	23682	21621	0.3625678	0.5411239	0.4521308
Islets_beta	Islets_PP	34019	63734	63824	29715	29805	0.175999	0.4198991	0.3209225
Islets_beta	Islets_acinar	31129	63734	66719	32605	35590	0.08135985	0.3525985	0.2467807
Islets_beta	Islets_duct	27235	63734	63744	36499	36509	-0.007030404	0.2916221	0.182637
Islets_beta	Islets_endothelial	26729	63734	64155	37005	37426	-0.04180698	0.2507665	0.144244
Islets_beta	Islets_immune	23140	63734	67939	40594	44799	-0.1471857	0.176225	0.0644757
Islets_beta	Islets_mesenchymal	26773	63734	62786	36961	36013	-0.01352731	0.2816908	0.1739016
Islets_beta	HCT116	19667	63734	64892	44067	45225	-0.2197436	0.1164513	0.002982702
Islets_beta	WTC11_from_HPC_diff	18366	63734	58398	45368	40032	-0.2274323	0.116404	0.002517656
Islets_beta	Jurkat	16253	63734	58783	47481	42530	-0.2992657	0.04478146	-0.06778246
Islets_alpha	Islets_alpha	65486	65486	65486	0	0	1	1	1
Islets_alpha	Islets_delta	39206	65486	61673	26280	22467	0.3356503	0.5366231	0.4443415
Islets_alpha	Islets_PP	36428	65486	63824	29058	27396	0.221467	0.4555442	0.3579106
Islets_alpha	Islets_acinar	31826	65486	66719	33660	34893	0.0982235	0.3775985	0.2706635
Islets_alpha	Islets_duct	27998	65486	63744	37488	35746	0.01020529	0.3163721	0.2061598
Islets_alpha	Islets_endothelial	25987	65486	64155	39499	38168	-0.06234499	0.250212	0.1405169
Islets_alpha	Islets_immune	23008	65486	67939	42478	44931	-0.1545874	0.1811054	0.06796583
Islets_alpha	Islets_mesenchymal	26527	65486	62786	38959	36259	-0.01875175	0.2920569	0.181685
Islets_alpha	HCT116	19477	65486	64892	46009	45415	-0.2264489	0.1224532	0.007414278
Islets_alpha	WTC11_from_HPC_diff	18565	65486	58398	46921	39833	-0.2204936	0.1346444	0.01932293
Islets_alpha	Jurkat	16022	65486	58783	49464	42761	-0.3094377	0.04470112	-0.06903899
Islets_delta	Islets_delta	61673	61673	61673	0	0	1	1	1
Islets_delta	Islets_PP	36846	61673	63824	24827	26978	0.2646765	0.4827303	0.3874929
Islets_delta	Islets_acinar	31815	61673	66719	29858	34904	0.1209009	0.3883211	0.2833528
Islets_delta	Islets_duct	29023	61673	63744	32650	34721	0.05601106	0.3454549	0.2377372
Islets_delta	Islets_endothelial	27511	61673	64155	34162	36644	-0.002097942	0.2914465	0.184565
Islets_delta	Islets_immune	23958	61673	67939	37715	43981	-0.1146127	0.2093059	0.09786427
Islets_delta	Islets_mesenchymal	27415	61673	62786	34258	35371	0.02258369	0.3199373	0.2114908
Islets_delta	HCT116	20305	61673	64892	41368	44587	-0.185505	0.1556136	0.04121247
Islets_delta	WTC11_from_HPC_diff	19410	61673	58398	42263	38988	-0.1819267	0.1658702	0.05087662
Islets_delta	Jurkat	16708	61673	58783	44965	42075	-0.2759829	0.07350363	-0.04019148
Islets_PP	Islets_PP	63824	63824	63824	0	0	1	1	1
Islets_PP	Islets_acinar	29952	63824	66719	33872	36767	0.05690442	0.3504653	0.2417927
Islets_PP	Islets_duct	28293	63824	63744	35531	35451	0.02233567	0.3269826	0.2169359
Islets_PP	Islets_endothelial	27372	63824	64155	36452	36783	-0.01883864	0.2858584	0.1769901
Islets_PP	Islets_immune	23759	63824	67939	40065	44180	-0.1265383	0.2101008	0.09595114
Islets_PP	Islets_mesenchymal	26338	63824	62786	37486	36448	-0.02127221	0.2928724	0.1822911
Islets_PP	HCT116	19735	63824	64892	44089	45157	-0.2078187	0.1483578	0.03129053
Islets_PP	WTC11_from_HPC_diff	18472	63824	58398	45352	39926	-0.2122914	0.1510677	0.03378209
Islets_PP	Jurkat	16219	63824	58783	47605	42564	-0.2948335	0.06603164	-0.04948692
Islets_acinar	Islets_acinar	66719	66719	66719	0	0	1	1	1
Islets_acinar	Islets_duct	35795	66719	63744	30924	27949	0.1923133	0.4290306	0.3296891
Islets_acinar	Islets_endothelial	27153	66719	64155	39566	37002	-0.03559783	0.2671681	0.1576342
Islets_acinar	Islets_immune	24967	66719	67939	41752	42972	-0.115606	0.2064583	0.09392658
Islets_acinar	Islets_mesenchymal	29092	66719	62786	37627	33694	0.02910667	0.3168847	0.2090667
Islets_acinar	HCT116	23573	66719	64892	43146	41319	-0.137022	0.1848928	0.07355502
Islets_acinar	WTC11_from_HPC_diff	20024	66719	58398	46695	38374	-0.1845614	0.1612944	0.04577491
Islets_acinar	Jurkat	17014	66719	58783	49705	41769	-0.2922749	0.05355502	-0.06010294
Islets_duct	Islets_duct	63744	63744	63744	0	0	1	1	1
Islets_duct	Islets_endothelial	27636	63744	64155	36108	36519	-0.01368284	0.2850971	0.1763115
Islets_duct	Islets_immune	25455	63744	67939	38289	42484	-0.08949574	0.2303368	0.1180677
Islets_duct	Islets_mesenchymal	28921	63744	62786	34823	33865	0.03466139	0.3232701	0.2156332
Islets_duct	HCT116	24260	63744	64892	39484	40632	-0.09979525	0.218676	0.1080208
Islets_duct	WTC11_from_HPC_diff	20014	63744	58398	43730	38384	-0.1697889	0.182102	0.06567687
Islets_duct	Jurkat	16624	63744	58783	47120	42159	-0.2886905	0.06394523	-0.05060572
Islets_endothelial	Islets_endothelial	64155	64155	64155	0	0	1	1	1
Islets_endothelial	Islets_immune	27290	64155	67939	36865	40649	-0.05609011	0.2472444	0.1377984
Islets_endothelial	Islets_mesenchymal	28899	64155	62786	35256	33887	0.02194773	0.3036051	0.1985375
Islets_endothelial	HCT116	21864	64155	64892	42291	43028	-0.1582582	0.1787455	0.06438218
Islets_endothelial	WTC11_from_HPC_diff	19054	64155	58398	45101	39344	-0.2077832	0.1426521	0.02801269
Islets_endothelial	Jurkat	17975	64155	58783	46180	40808	-0.2486719	0.1006375	-0.01382989
Islets_immune	Islets_immune	67939	67939	67939	0	0	1	1	1
Islets_immune	Islets_mesenchymal	26361	67939	62786	41578	36425	-0.06543773	0.2402963	0.1309676
Islets_immune	HCT116	20945	67939	64892	46994	43947	-0.2051957	0.1387123	0.02339466
Islets_immune	WTC11_from_HPC_diff	17766	67939	58398	50173	40632	-0.2616707	0.09360665	-0.02165418
Islets_immune	Jurkat	18891	67939	58783	49048	39892	-0.2449157	0.09844308	-0.01498791
Islets_mesenchymal	Islets_mesenchymal	62786	62786	62786	0	0	1	1	1
Islets_mesenchymal	HCT116	22292	62786	64892	40494	42600	-0.1470891	0.1797936	0.06804221
Islets_mesenchymal	WTC11_from_HPC_diff	19794	62786	58398	42992	38604	-0.1757377	0.1711599	0.05635901
Islets_mesenchymal	Jurkat	17223	62786	58783	45563	41560	-0.2684957	0.07928782	-0.03412654
HCT116	HCT116	64892	64892	64892	0	0	1	1	1
HCT116	WTC11_from_HPC_diff	21539	64892	58398	43353	36859	-0.1548204	0.1682369	0.05779996
HCT116	Jurkat	21027	64892	58783	43865	37756	-0.1614984	0.1727357	0.05828342
WTC11_from_HPC_diff	WTC11_from_HPC_diff	58398	58398	58398	0	0	1	1	1
WTC11_from_HPC_diff	Jurkat	16987	58398	58783	41411	41796	-0.2784481	0.05668256	-0.05294345
Jurkat	Jurkat	58783	58783	58783	0	0	1	1	1
